geceici	 g e c e i c i
bcjhebh	 b c j h e b h
afhdg	 a f h d g
dcb	 d c b
ghgdibde	 g h g d i b d e
iaijg	 i a i j g
echfg	 e c h f g
edfichbgf	 e d f i c h b g f
cc	 c c
gcfchcfc	 g c f c h c f c
fdejib	 f d e j i b
gejifb	 g e j i f b
ba	 b a
hfjfbha	 h f j f b h a
ecda	 e c d a
ebd	 e b d
jjfe	 j j f e
gihcdf	 g i h c d f
hjifjacfb	 h j i f j a c f b
gaej	 g a e j
deai	 d e a i
jbijb	 j b i j b
bfb	 b f b
fedbfhabj	 f e d b f h a b j
hgf	 h g f
acfegih	 a c f e g i h
fgeigadfe	 f g e i g a d f e
hg	 h g
ichg	 i c h g
ecihaid	 e c i h a i d
agajj	 a g a j j
ac	 a c
ibagdi	 i b a g d i
idajegda	 i d a j e g d a
dafbe	 d a f b e
jhhaf	 j h h a f
ed	 e d
ifd	 i f d
bfajjh	 b f a j j h
bibfh	 b i b f h
ciebhf	 c i e b h f
jb	 j b
fc	 f c
bfgbdd	 b f g b d d
jhb	 j h b
gdi	 g d i
ch	 c h
iijbccg	 i i j b c c g
ihg	 i h g
gjahdgcc	 g j a h d g c c
eb	 e b
iafcicjh	 i a f c i c j h
efi	 e f i
jcijdicc	 j c i j d i c c
dbfgh	 d b f g h
fi	 f i
cigdhbf	 c i g d h b f
eac	 e a c
cfagjihi	 c f a g j i h i
hjeg	 h j e g
ccbcg	 c c b c g
ab	 a b
ii	 i i
hjhhcij	 h j h h c i j
fhdb	 f h d b
haeiffb	 h a e i f f b
hcjfcaga	 h c j f c a g a
bjb	 b j b
fjgjfe	 f j g j f e
haaaccj	 h a a a c c j
jfejcj	 j f e j c j
adaihcjij	 a d a i h c j i j
ijfch	 i j f c h
bcbiagej	 b c b i a g e j
cdicf	 c d i c f
hjigg	 h j i g g
ecfffh	 e c f f f h
fjeihdb	 f j e i h d b
ehc	 e h c
hbaihbgd	 h b a i h b g d
dbhjcibj	 d b h j c i b j
dcibfcad	 d c i b f c a d
fjh	 f j h
bhigfdda	 b h i g f d d a
dccaa	 d c c a a
bjfjie	 b j f j i e
jcga	 j c g a
ai	 a i
dcaiacbf	 d c a i a c b f
hb	 h b
fdj	 f d j
ghe	 g h e
hheica	 h h e i c a
bibi	 b i b i
jgjdc	 j g j d c
dadhab	 d a d h a b
bi	 b i
cigjj	 c i g j j
bcee	 b c e e
befgi	 b e f g i
jci	 j c i
egcb	 e g c b
hcc	 h c c
ii	 i i
aag	 a a g
cjifd	 c j i f d
gdicj	 g d i c j
efdcghejf	 e f d c g h e j f
hgh	 h g h
ghage	 g h a g e
jeidecdi	 j e i d e c d i
hgbgcbg	 h g b g c b g
eebacaa	 e e b a c a a
if	 i f
hhdia	 h h d i a
eie	 e i e
ed	 e d
hdjgjha	 h d j g j h a
fafjd	 f a f j d
jddggcc	 j d d g g c c
bfbbe	 b f b b e
jfhjcfig	 j f h j c f i g
egejii	 e g e j i i
aedh	 a e d h
gcadbiac	 g c a d b i a c
je	 j e
je	 j e
agdbadhde	 a g d b a d h d e
jgddje	 j g d d j e
gedb	 g e d b
hfghifdi	 h f g h i f d i
fifhich	 f i f h i c h
ajgia	 a j g i a
cgaeh	 c g a e h
ahdfchibg	 a h d f c h i b g
gcd	 g c d
hadaj	 h a d a j
hi	 h i
ajfeebd	 a j f e e b d
hch	 h c h
jj	 j j
fbhgfa	 f b h g f a
hebcfe	 h e b c f e
jdgjabjji	 j d g j a b j j i
ghgeedjd	 g h g e e d j d
dcf	 d c f
cic	 c i c
jcgf	 j c g f
cieba	 c i e b a
gaig	 g a i g
eaccc	 e a c c c
hc	 h c
jcghicddj	 j c g h i c d d j
hadac	 h a d a c
dafdbfa	 d a f d b f a
iihcjf	 i i h c j f
hgjd	 h g j d
djede	 d j e d e
gbdgh	 g b d g h
eddfj	 e d d f j
fjebb	 f j e b b
fjgbdifbc	 f j g b d i f b c
gd	 g d
jcf	 j c f
ebhi	 e b h i
gbe	 g b e
jbecd	 j b e c d
ghiegce	 g h i e g c e
gh	 g h
cff	 c f f
daja	 d a j a
ggcghfa	 g g c g h f a
ichc	 i c h c
diff	 d i f f
ceagh	 c e a g h
cadfa	 c a d f a
aha	 a h a
fgcg	 f g c g
dbdbaf	 d b d b a f
gicffdhh	 g i c f f d h h
hceeaj	 h c e e a j
jcbae	 j c b a e
ahfe	 a h f e
iijajc	 i i j a j c
bfgfc	 b f g f c
fcdgecfda	 f c d g e c f d a
ijiciciii	 i j i c i c i i i
cdgjih	 c d g j i h
fgii	 f g i i
gahchgh	 g a h c h g h
jjaegdjhh	 j j a e g d j h h
aeife	 a e i f e
hfceceic	 h f c e c e i c
icc	 i c c
jccjci	 j c c j c i
eejae	 e e j a e
die	 d i e
igbid	 i g b i d
affbgff	 a f f b g f f
hfe	 h f e
acd	 a c d
cfg	 c f g
jib	 j i b
ahafbibjg	 a h a f b i b j g
dcfcahgh	 d c f c a h g h
cee	 c e e
ddhajca	 d d h a j c a
afah	 a f a h
dijdf	 d i j d f
fcbc	 f c b c
gggi	 g g g i
cjefb	 c j e f b
ieaf	 i e a f
fbbg	 f b b g
fbgihc	 f b g i h c
gcgc	 g c g c
ddhdhfgg	 d d h d h f g g
bdjhbh	 b d j h b h
gh	 g h
fagegacjb	 f a g e g a c j b
agibdid	 a g i b d i d
ccaaefeed	 c c a a e f e e d
fbf	 f b f
ghhg	 g h h g
icbfbgd	 i c b f b g d
ec	 e c
bafhced	 b a f h c e d
cdcbjjhf	 c d c b j j h f
hdjgbjc	 h d j g b j c
iih	 i i h
idcgb	 i d c g b
idci	 i d c i
ed	 e d
agjdibjj	 a g j d i b j j
ecgcgcbba	 e c g c g c b b a
gghj	 g g h j
gideicc	 g i d e i c c
cfceeegij	 c f c e e e g i j
baiaic	 b a i a i c
iajbaj	 i a j b a j
ahjadjfi	 a h j a d j f i
hahebhj	 h a h e b h j
fgbdicde	 f g b d i c d e
cjcdg	 c j c d g
jcdicgjh	 j c d i c g j h
jiiiciebd	 j i i i c i e b d
ehdhdef	 e h d h d e f
iccbjfajh	 i c c b j f a j h
dcdgjebh	 d c d g j e b h
bjca	 b j c a
bhibc	 b h i b c
bggcidcbf	 b g g c i d c b f
gdhjhfjed	 g d h j h f j e d
fjcfce	 f j c f c e
egaafh	 e g a a f h
hihg	 h i h g
ifcjhged	 i f c j h g e d
iifiigja	 i i f i i g j a
hejcchgia	 h e j c c h g i a
hjccghf	 h j c c g h f
hb	 h b
jdbecddid	 j d b e c d d i d
ibdiigiid	 i b d i i g i i d
ihb	 i h b
gahfgd	 g a h f g d
ejhjhidf	 e j h j h i d f
eiaicjfaf	 e i a i c j f a f
cahebebbd	 c a h e b e b b d
jagfbefch	 j a g f b e f c h
afif	 a f i f
jgigcceei	 j g i g c c e e i
hdjjfigdf	 h d j j f i g d f
aebhjjg	 a e b h j j g
hcccaedi	 h c c c a e d i
ai	 a i
ceggfdiah	 c e g g f d i a h
idcb	 i d c b
cfhjagi	 c f h j a g i
ehefeegi	 e h e f e e g i
jc	 j c
ihijgief	 i h i j g i e f
gghajff	 g g h a j f f
eahbbcfbc	 e a h b b c f b c
eeadiibbc	 e e a d i i b b c
eadbg	 e a d b g
aaccbcfaa	 a a c c b c f a a
ieffffjd	 i e f f f f j d
aacgab	 a a c g a b
bchbi	 b c h b i
bejhe	 b e j h e
fefiehje	 f e f i e h j e
ahgfgiif	 a h g f g i i f
if	 i f
dhffcjdd	 d h f f c j d d
hie	 h i e
egfiddjbf	 e g f i d d j b f
hbahe	 h b a h e
gh	 g h
ehiebhaj	 e h i e b h a j
ihjbefaee	 i h j b e f a e e
ach	 a c h
ccebeifgc	 c c e b e i f g c
jejeig	 j e j e i g
cab	 c a b
idjajdejj	 i d j a j d e j j
jjcj	 j j c j
ja	 j a
bbabea	 b b a b e a
cid	 c i d
bfibge	 b f i b g e
jghge	 j g h g e
ihgf	 i h g f
cbbcbjh	 c b b c b j h
eifhfdah	 e i f h f d a h
dfgce	 d f g c e
cc	 c c
ii	 i i
fedaaeccc	 f e d a a e c c c
jjah	 j j a h
ebfjjjb	 e b f j j j b
hfihh	 h f i h h
ibidf	 i b i d f
cfigbd	 c f i g b d
jiccgdiej	 j i c c g d i e j
afhjdjgce	 a f h j d j g c e
bceeebegb	 b c e e e b e g b
dciadadec	 d c i a d a d e c
hjjg	 h j j g
hjj	 h j j
gcgbfegc	 g c g b f e g c
eddcahbic	 e d d c a h b i c
eechc	 e e c h c
dehbhdb	 d e h b h d b
bfbgjf	 b f b g j f
fhdifh	 f h d i f h
hj	 h j
gfbhfigfd	 g f b h f i g f d
jgbif	 j g b i f
gjifceji	 g j i f c e j i
ha	 h a
gdic	 g d i c
agh	 a g h
gcfe	 g c f e
hccje	 h c c j e
cch	 c c h
fdahbdb	 f d a h b d b
fafgagb	 f a f g a g b
dcha	 d c h a
ahhja	 a h h j a
edbgjb	 e d b g j b
egfe	 e g f e
fdajceca	 f d a j c e c a
fahfice	 f a h f i c e
bhbf	 b h b f
ab	 a b
ihcj	 i h c j
hifg	 h i f g
ea	 e a
hfcbghhaa	 h f c b g h h a a
ffffijhi	 f f f f i j h i
ajifa	 a j i f a
aj	 a j
iecgiah	 i e c g i a h
gecbhf	 g e c b h f
bacg	 b a c g
ecfjffbic	 e c f j f f b i c
agc	 a g c
bii	 b i i
higjjd	 h i g j j d
decjicj	 d e c j i c j
bbehbhdbb	 b b e h b h d b b
hghehjdc	 h g h e h j d c
bcjb	 b c j b
fefejgehg	 f e f e j g e h g
icbidg	 i c b i d g
fiadadgd	 f i a d a d g d
gcjjhhc	 g c j j h h c
ejhdheghg	 e j h d h e g h g
dgbchjc	 d g b c h j c
dibahdbc	 d i b a h d b c
gjifijeie	 g j i f i j e i e
ffidca	 f f i d c a
aibjj	 a i b j j
eiaa	 e i a a
ehcag	 e h c a g
ehifch	 e h i f c h
jjbfd	 j j b f d
jfedjd	 j f e d j d
dihecb	 d i h e c b
ghdjebgj	 g h d j e b g j
jbiidf	 j b i i d f
gi	 g i
bbibeebie	 b b i b e e b i e
agjdje	 a g j d j e
jaggeci	 j a g g e c i
bhaaajbg	 b h a a a j b g
adg	 a d g
bde	 b d e
djbeicca	 d j b e i c c a
gi	 g i
hiadahjag	 h i a d a h j a g
ahjgdi	 a h j g d i
hhjeaj	 h h j e a j
ehage	 e h a g e
agc	 a g c
hj	 h j
dgfieieaj	 d g f i e i e a j
ghf	 g h f
cd	 c d
bgf	 b g f
bicab	 b i c a b
jfbbihb	 j f b b i h b
daiegh	 d a i e g h
ihdcd	 i h d c d
ahgebfg	 a h g e b f g
acbcbi	 a c b c b i
gjcace	 g j c a c e
hjcbjiib	 h j c b j i i b
iafjf	 i a f j f
ea	 e a
bcge	 b c g e
dej	 d e j
fjhf	 f j h f
dhdba	 d h d b a
bfegi	 b f e g i
eeifaach	 e e i f a a c h
ec	 e c
bcdffcfdh	 b c d f f c f d h
cej	 c e j
ebf	 e b f
aeecibcdi	 a e e c i b c d i
ifecdcbce	 i f e c d c b c e
fifbdchd	 f i f b d c h d
jj	 j j
aaciaegah	 a a c i a e g a h
ghfghhdh	 g h f g h h d h
ghgiea	 g h g i e a
iifg	 i i f g
ee	 e e
addf	 a d d f
dhiidgbg	 d h i i d g b g
hgb	 h g b
ebibaa	 e b i b a a
ejifgfbh	 e j i f g f b h
dhgda	 d h g d a
bjadfgaeg	 b j a d f g a e g
ajgfdf	 a j g f d f
gehgjibce	 g e h g j i b c e
efh	 e f h
giecji	 g i e c j i
eegjac	 e e g j a c
abjbjf	 a b j b j f
ggdgahc	 g g d g a h c
ddjbhgi	 d d j b h g i
iijhgag	 i i j h g a g
dhhgaggg	 d h h g a g g g
jg	 j g
hbecijgc	 h b e c i j g c
iebi	 i e b i
iiie	 i i i e
higgf	 h i g g f
cfgd	 c f g d
eaggijbb	 e a g g i j b b
cg	 c g
eeeaiic	 e e e a i i c
bghcahd	 b g h c a h d
cdehbjbgj	 c d e h b j b g j
fggbgedch	 f g g b g e d c h
ibg	 i b g
jhbggfij	 j h b g g f i j
iiaiffdgh	 i i a i f f d g h
gcdbe	 g c d b e
bcjg	 b c j g
db	 d b
ccbcfd	 c c b c f d
ja	 j a
bdi	 b d i
iheeff	 i h e e f f
gahidgg	 g a h i d g g
be	 b e
iadef	 i a d e f
da	 d a
cc	 c c
jih	 j i h
jgicijg	 j g i c i j g
egiacbff	 e g i a c b f f
aag	 a a g
hdbaffd	 h d b a f f d
jfeei	 j f e e i
djb	 d j b
jcfe	 j c f e
adigg	 a d i g g
ga	 g a
dhifbh	 d h i f b h
efh	 e f h
ehhhi	 e h h h i
agfhgbj	 a g f h g b j
afi	 a f i
ebb	 e b b
fcfcgbci	 f c f c g b c i
fhfbca	 f h f b c a
ejibhchh	 e j i b h c h h
dh	 d h
ac	 a c
jhg	 j h g
aeafc	 a e a f c
gefig	 g e f i g
ff	 f f
daagihgeb	 d a a g i h g e b
fhieeci	 f h i e e c i
id	 i d
ifh	 i f h
debgfdc	 d e b g f d c
ifcg	 i f c g
bhcfigae	 b h c f i g a e
ciecfd	 c i e c f d
gdfdjjag	 g d f d j j a g
jb	 j b
ihdafbefg	 i h d a f b e f g
chaea	 c h a e a
ifdhgbb	 i f d h g b b
efhhibbi	 e f h h i b b i
fjch	 f j c h
hba	 h b a
ecceia	 e c c e i a
ib	 i b
eec	 e e c
dggcijjc	 d g g c i j j c
ahhdg	 a h h d g
aejb	 a e j b
fjaeabhc	 f j a e a b h c
hjjbahdf	 h j j b a h d f
bdff	 b d f f
fihbbf	 f i h b b f
gjh	 g j h
gbhcj	 g b h c j
chggbcjda	 c h g g b c j d a
ggbfgiajh	 g g b f g i a j h
hidjhd	 h i d j h d
cj	 c j
jabhgageh	 j a b h g a g e h
jgiib	 j g i i b
fdfefgch	 f d f e f g c h
cbf	 c b f
fehda	 f e h d a
gjhjhicf	 g j h j h i c f
ebec	 e b e c
ddfd	 d d f d
bcah	 b c a h
ddgjgc	 d d g j g c
he	 h e
jaghgbcgj	 j a g h g b c g j
ifcaegfg	 i f c a e g f g
jdijih	 j d i j i h
aiddjjj	 a i d d j j j
aicag	 a i c a g
bdc	 b d c
adgffadbj	 a d g f f a d b j
dfg	 d f g
cjecbajf	 c j e c b a j f
cga	 c g a
feehfdi	 f e e h f d i
baed	 b a e d
gi	 g i
ajgdjacad	 a j g d j a c a d
ihfgf	 i h f g f
ehbhieae	 e h b h i e a e
dhhgabh	 d h h g a b h
fejijgh	 f e j i j g h
dhecddjgf	 d h e c d d j g f
hed	 h e d
eihfbcci	 e i h f b c c i
ahadfca	 a h a d f c a
geibgbii	 g e i b g b i i
deibeaddd	 d e i b e a d d d
jad	 j a d
hdefe	 h d e f e
hgcfbhf	 h g c f b h f
igdjaj	 i g d j a j
cicd	 c i c d
ci	 c i
cajjbe	 c a j j b e
heehbedd	 h e e h b e d d
fdica	 f d i c a
eijchfd	 e i j c h f d
ffbfibj	 f f b f i b j
aid	 a i d
gbahdje	 g b a h d j e
je	 j e
icgfg	 i c g f g
dai	 d a i
bbccjae	 b b c c j a e
caa	 c a a
cd	 c d
hhgjj	 h h g j j
ahgdg	 a h g d g
dahicdia	 d a h i c d i a
facgjhf	 f a c g j h f
jecff	 j e c f f
dec	 d e c
hg	 h g
iicfd	 i i c f d
hjibhi	 h j i b h i
gj	 g j
hbejc	 h b e j c
cb	 c b
cgcbc	 c g c b c
hcace	 h c a c e
dbe	 d b e
bcg	 b c g
iedfhg	 i e d f h g
fjebb	 f j e b b
bdbhjejd	 b d b h j e j d
bdaajci	 b d a a j c i
biee	 b i e e
dbj	 d b j
fgii	 f g i i
bde	 b d e
ibcge	 i b c g e
jddibc	 j d d i b c
ggfgedgia	 g g f g e d g i a
ab	 a b
cjfb	 c j f b
fibgd	 f i b g d
haedgfha	 h a e d g f h a
gg	 g g
jcdjbhiac	 j c d j b h i a c
bcdgj	 b c d g j
chbba	 c h b b a
ddaaj	 d d a a j
dg	 d g
bfadfi	 b f a d f i
fdcg	 f d c g
cj	 c j
ebcbie	 e b c b i e
ehgffi	 e h g f f i
dbjdb	 d b j d b
djgbi	 d j g b i
dfdfchi	 d f d f c h i
iejcegj	 i e j c e g j
ib	 i b
ifcae	 i f c a e
ccicf	 c c i c f
iaeeaa	 i a e e a a
hddcg	 h d d c g
hdaiffah	 h d a i f f a h
egifebgaa	 e g i f e b g a a
ic	 i c
ai	 a i
ddjfg	 d d j f g
iecib	 i e c i b
jdbhcc	 j d b h c c
ej	 e j
bf	 b f
djbibiced	 d j b i b i c e d
gheaaagji	 g h e a a a g j i
fjdicahe	 f j d i c a h e
ehjcc	 e h j c c
iggi	 i g g i
cbdhbccc	 c b d h b c c c
gaaigja	 g a a i g j a
hghj	 h g h j
hdhfja	 h d h f j a
cc	 c c
fhjciajf	 f h j c i a j f
bbeidj	 b b e i d j
djfhfge	 d j f h f g e
ibfggjf	 i b f g g j f
jij	 j i j
hhffhfja	 h h f f h f j a
gciei	 g c i e i
bhbfjhed	 b h b f j h e d
hca	 h c a
ddcbg	 d d c b g
eacedbbb	 e a c e d b b b
hj	 h j
heaabfdhd	 h e a a b f d h d
gaa	 g a a
eaf	 e a f
gcbedgcb	 g c b e d g c b
iaedhjebd	 i a e d h j e b d
ficcgej	 f i c c g e j
gdaghca	 g d a g h c a
di	 d i
digi	 d i g i
fibhc	 f i b h c
fjafeg	 f j a f e g
hbjeaa	 h b j e a a
ciaa	 c i a a
ifeeb	 i f e e b
fbfdgcahh	 f b f d g c a h h
adcdiaia	 a d c d i a i a
ef	 e f
aafjdegg	 a a f j d e g g
bih	 b i h
ica	 i c a
idci	 i d c i
ececj	 e c e c j
fdjijjahg	 f d j i j j a h g
fffghjg	 f f f g h j g
jecdef	 j e c d e f
aegeh	 a e g e h
cccahfd	 c c c a h f d
fifiieh	 f i f i i e h
ge	 g e
gc	 g c
acdad	 a c d a d
chfchfbae	 c h f c h f b a e
hgfbf	 h g f b f
bjiajhij	 b j i a j h i j
iajcjdcb	 i a j c j d c b
hccbdac	 h c c b d a c
ed	 e d
eeiifjb	 e e i i f j b
eehfjfced	 e e h f j f c e d
gjdeagi	 g j d e a g i
acd	 a c d
bche	 b c h e
ffajgi	 f f a j g i
hjebec	 h j e b e c
gdiggjd	 g d i g g j d
fgd	 f g d
deicc	 d e i c c
jcjheiaji	 j c j h e i a j i
giagff	 g i a g f f
ijhabi	 i j h a b i
fggahgb	 f g g a h g b
bcejcigia	 b c e j c i g i a
agac	 a g a c
dgge	 d g g e
jibfcgjd	 j i b f c g j d
egc	 e g c
gbbcjja	 g b b c j j a
acg	 a c g
gf	 g f
ejgde	 e j g d e
gbhidied	 g b h i d i e d
idcedagf	 i d c e d a g f
decdgbiag	 d e c d g b i a g
fbdi	 f b d i
bie	 b i e
dhjgedhda	 d h j g e d h d a
bjab	 b j a b
geahfggb	 g e a h f g g b
ij	 i j
ecefdfc	 e c e f d f c
jbcfj	 j b c f j
bcabif	 b c a b i f
bhidiejg	 b h i d i e j g
jc	 j c
cgbddfi	 c g b d d f i
dgfjcea	 d g f j c e a
heijhii	 h e i j h i i
bhfijjacd	 b h f i j j a c d
haae	 h a a e
gbfjhei	 g b f j h e i
fcighg	 f c i g h g
idbfbibaf	 i d b f b i b a f
hbbffcfd	 h b b f f c f d
cdfebcb	 c d f e b c b
bhdajjacf	 b h d a j j a c f
ahcbh	 a h c b h
febf	 f e b f
bgejgbb	 b g e j g b b
dghabc	 d g h a b c
ehibbbjhb	 e h i b b b j h b
fh	 f h
fggaeiie	 f g g a e i i e
ghbgacib	 g h b g a c i b
aijfdifd	 a i j f d i f d
fbjgf	 f b j g f
cadg	 c a d g
iiibdcaj	 i i i b d c a j
ihjfh	 i h j f h
gafideada	 g a f i d e a d a
bjjfi	 b j j f i
jdiaffe	 j d i a f f e
jbeg	 j b e g
aggaci	 a g g a c i
jicgeg	 j i c g e g
hj	 h j
cgicdhg	 c g i c d h g
bjbfj	 b j b f j
bidiebc	 b i d i e b c
ibcbc	 i b c b c
iachhda	 i a c h h d a
ijgceihd	 i j g c e i h d
dgii	 d g i i
ijiigeg	 i j i i g e g
fhfhcibdi	 f h f h c i b d i
jidfhh	 j i d f h h
cbbfaif	 c b b f a i f
aedfjadej	 a e d f j a d e j
cbbj	 c b b j
gghbj	 g g h b j
dfjcgh	 d f j c g h
aaa	 a a a
dajbibce	 d a j b i b c e
gcdjfg	 g c d j f g
gjhfc	 g j h f c
ggdbiagi	 g g d b i a g i
afagej	 a f a g e j
cdfdacg	 c d f d a c g
dbjbjjcd	 d b j b j j c d
jajbcihcf	 j a j b c i h c f
gd	 g d
hcaahaeb	 h c a a h a e b
gibjdb	 g i b j d b
fhfhecbd	 f h f h e c b d
fjeejfh	 f j e e j f h
fghaf	 f g h a f
aa	 a a
cfd	 c f d
fec	 f e c
fg	 f g
bfcccdhbc	 b f c c c d h b c
bajbj	 b a j b j
jchcc	 j c h c c
bgdcj	 b g d c j
edfhbifij	 e d f h b i f i j
hafhgi	 h a f h g i
ajac	 a j a c
da	 d a
affhab	 a f f h a b
jee	 j e e
cih	 c i h
echbhgih	 e c h b h g i h
ffigjbge	 f f i g j b g e
ijfhj	 i j f h j
ejeb	 e j e b
gdhaa	 g d h a a
bhbjiifhj	 b h b j i i f h j
ai	 a i
efaib	 e f a i b
fhdbjj	 f h d b j j
da	 d a
beaf	 b e a f
hijjg	 h i j j g
edg	 e d g
ji	 j i
gchechfie	 g c h e c h f i e
hgajah	 h g a j a h
ichaadhg	 i c h a a d h g
bdfdci	 b d f d c i
dbibejaj	 d b i b e j a j
bdfcaab	 b d f c a a b
eacaejcef	 e a c a e j c e f
hibiie	 h i b i i e
be	 b e
gdabaf	 g d a b a f
jfgdg	 j f g d g
dajej	 d a j e j
iaj	 i a j
ddhccabe	 d d h c c a b e
hjjhiia	 h j j h i i a
chjj	 c h j j
jjcfdjg	 j j c f d j g
agc	 a g c
gbi	 g b i
aghhaeagh	 a g h h a e a g h
geeibafcc	 g e e i b a f c c
fichd	 f i c h d
haiibji	 h a i i b j i
figajbdhh	 f i g a j b d h h
cbihieah	 c b i h i e a h
ihj	 i h j
jccbe	 j c c b e
efgbc	 e f g b c
eciacefg	 e c i a c e f g
ecf	 e c f
cdghaab	 c d g h a a b
jdchj	 j d c h j
fc	 f c
dj	 d j
ffijfdhdh	 f f i j f d h d h
ggfdiei	 g g f d i e i
dafbgdej	 d a f b g d e j
djjabhfgb	 d j j a b h f g b
iiiiec	 i i i i e c
fbfegih	 f b f e g i h
jcajc	 j c a j c
eda	 e d a
bj	 b j
adhgidei	 a d h g i d e i
fbebf	 f b e b f
dfdgbbac	 d f d g b b a c
acbebccj	 a c b e b c c j
hjj	 h j j
abgjhai	 a b g j h a i
egdjgjajg	 e g d j g j a j g
bbj	 b b j
ajedbbbhj	 a j e d b b b h j
ghfbdhg	 g h f b d h g
adaehfhbh	 a d a e h f h b h
bb	 b b
jhdiajh	 j h d i a j h
djifj	 d j i f j
bgdgaef	 b g d g a e f
hidiia	 h i d i i a
fbhihga	 f b h i h g a
bjfafhhdi	 b j f a f h h d i
ccba	 c c b a
aeiciefg	 a e i c i e f g
cggahj	 c g g a h j
ijgaiagbg	 i j g a i a g b g
ihidhd	 i h i d h d
bfig	 b f i g
ahhidh	 a h h i d h
cbdfgha	 c b d f g h a
gc	 g c
bhjddd	 b h j d d d
cieida	 c i e i d a
fjac	 f j a c
cgffabdf	 c g f f a b d f
ghhjea	 g h h j e a
hab	 h a b
bh	 b h
jjahiij	 j j a h i i j
ceibjagha	 c e i b j a g h a
bfhbicia	 b f h b i c i a
fdahh	 f d a h h
dhec	 d h e c
jfcc	 j f c c
fi	 f i
hb	 h b
hegjjch	 h e g j j c h
jgj	 j g j
cahiafdc	 c a h i a f d c
egbihccbg	 e g b i h c c b g
ehjb	 e h j b
hiij	 h i i j
fa	 f a
jbdbcaicd	 j b d b c a i c d
bfdhhei	 b f d h h e i
fec	 f e c
ah	 a h
ba	 b a
hcje	 h c j e
jgd	 j g d
edjjfia	 e d j j f i a
jgid	 j g i d
id	 i d
hfahgfjbb	 h f a h g f j b b
dhac	 d h a c
gib	 g i b
idbgabgd	 i d b g a b g d
bhcada	 b h c a d a
bh	 b h
bchfbbb	 b c h f b b b
cafhcici	 c a f h c i c i
gbbdi	 g b b d i
aegji	 a e g j i
dg	 d g
iaeafhieg	 i a e a f h i e g
iijeiii	 i i j e i i i
jdbdb	 j d b d b
ghehbe	 g h e h b e
beajjbd	 b e a j j b d
eab	 e a b
fbcigih	 f b c i g i h
cihc	 c i h c
gbifjcee	 g b i f j c e e
dfbbhiaga	 d f b b h i a g a
hih	 h i h
fceigj	 f c e i g j
cfb	 c f b
icdab	 i c d a b
jj	 j j
bh	 b h
febjggjj	 f e b j g g j j
feebh	 f e e b h
acj	 a c j
ifdcdc	 i f d c d c
de	 d e
bi	 b i
chd	 c h d
beeg	 b e e g
ibjcbj	 i b j c b j
ijdadajf	 i j d a d a j f
je	 j e
bdbjdij	 b d b j d i j
eajfff	 e a j f f f
jfge	 j f g e
hccjjb	 h c c j j b
cbaiefa	 c b a i e f a
ffcib	 f f c i b
fhfaah	 f h f a a h
dgdbbcijg	 d g d b b c i j g
dgjcg	 d g j c g
hi	 h i
ahgc	 a h g c
hjgbh	 h j g b h
cea	 c e a
faf	 f a f
iagedi	 i a g e d i
djggeg	 d j g g e g
edjeaaica	 e d j e a a i c a
ff	 f f
ce	 c e
ghefbdib	 g h e f b d i b
gf	 g f
aeggcid	 a e g g c i d
aeddhc	 a e d d h c
bjadd	 b j a d d
bifj	 b i f j
gcb	 g c b
iaiihcaih	 i a i i h c a i h
cgfahd	 c g f a h d
ijaf	 i j a f
eefahb	 e e f a h b
jcaij	 j c a i j
gedj	 g e d j
dchbb	 d c h b b
cid	 c i d
djji	 d j j i
dgc	 d g c
gjafi	 g j a f i
fjg	 f j g
chc	 c h c
edhide	 e d h i d e
egbchgiae	 e g b c h g i a e
bjfaij	 b j f a i j
jbd	 j b d
idbghh	 i d b g h h
dde	 d d e
cjaebcjhc	 c j a e b c j h c
gceffaaeg	 g c e f f a a e g
gfghaah	 g f g h a a h
babj	 b a b j
bhia	 b h i a
gfec	 g f e c
aa	 a a
ehad	 e h a d
aefjhef	 a e f j h e f
dhjbia	 d h j b i a
jjbhdjcj	 j j b h d j c j
cebaaffjc	 c e b a a f f j c
cedfgbc	 c e d f g b c
fbaibh	 f b a i b h
bbdeicjg	 b b d e i c j g
gdigihg	 g d i g i h g
jc	 j c
cbahb	 c b a h b
bff	 b f f
caeii	 c a e i i
gifhib	 g i f h i b
haacbdd	 h a a c b d d
ghbdgbf	 g h b d g b f
cbejcf	 c b e j c f
ecbgafeda	 e c b g a f e d a
jficcf	 j f i c c f
ibbaa	 i b b a a
gj	 g j
adbjbee	 a d b j b e e
cdechdi	 c d e c h d i
jfb	 j f b
gebefge	 g e b e f g e
jcjhdhgge	 j c j h d h g g e
dbejhaaa	 d b e j h a a a
dg	 d g
gdbad	 g d b a d
gdcigfb	 g d c i g f b
abadcih	 a b a d c i h
dfcdaada	 d f c d a a d a
gddjbi	 g d d j b i
hgfaecc	 h g f a e c c
eeedacagi	 e e e d a c a g i
fcfedbgb	 f c f e d b g b
iad	 i a d
de	 d e
jeggafch	 j e g g a f c h
adjeh	 a d j e h
fjdfhcbjj	 f j d f h c b j j
jicfigc	 j i c f i g c
ii	 i i
bej	 b e j
ddeidf	 d d e i d f
cddig	 c d d i g
dfgd	 d f g d
aca	 a c a
ifehjecga	 i f e h j e c g a
eghddjcdb	 e g h d d j c d b
ebi	 e b i
ji	 j i
fdgdbghae	 f d g d b g h a e
bii	 b i i
ffgdecadg	 f f g d e c a d g
fdiacghhd	 f d i a c g h h d
hia	 h i a
idddjjghe	 i d d d j j g h e
aac	 a a c
ahjdb	 a h j d b
gcfi	 g c f i
ghjg	 g h j g
aageji	 a a g e j i
edhe	 e d h e
daideich	 d a i d e i c h
jhebabhji	 j h e b a b h j i
ggaeii	 g g a e i i
ebj	 e b j
aie	 a i e
fahdje	 f a h d j e
dgdhdhi	 d g d h d h i
ecjchchcg	 e c j c h c h c g
iaigedfb	 i a i g e d f b
dcfaaaf	 d c f a a a f
ceaiebj	 c e a i e b j
edhbdaifi	 e d h b d a i f i
cdahhaj	 c d a h h a j
ccdfc	 c c d f c
hc	 h c
cdeg	 c d e g
bbhihje	 b b h i h j e
ijigae	 i j i g a e
idghfhg	 i d g h f h g
eahade	 e a h a d e
bigdea	 b i g d e a
ghgjjfgfd	 g h g j j f g f d
bh	 b h
bjg	 b j g
cijfdghb	 c i j f d g h b
bcgdhbccd	 b c g d h b c c d
bhf	 b h f
gcdaj	 g c d a j
hbafafa	 h b a f a f a
gg	 g g
beajhea	 b e a j h e a
eif	 e i f
ihh	 i h h
dgcbbfb	 d g c b b f b
eegedei	 e e g e d e i
ghed	 g h e d
chchjda	 c h c h j d a
gffjdj	 g f f j d j
bef	 b e f
jbfcfbb	 j b f c f b b
hfg	 h f g
bddbjdfa	 b d d b j d f a
ahejbje	 a h e j b j e
ejadaebf	 e j a d a e b f
aa	 a a
dhbbdagj	 d h b b d a g j
iijbcehid	 i i j b c e h i d
iiggdhejj	 i i g g d h e j j
bhcbd	 b h c b d
hcjacdgc	 h c j a c d g c
cfg	 c f g
gaebfjff	 g a e b f j f f
edhjbiegg	 e d h j b i e g g
gbc	 g b c
jddjea	 j d d j e a
gfgg	 g f g g
hbjh	 h b j h
aa	 a a
dcbbc	 d c b b c
ciic	 c i i c
eae	 e a e
idafc	 i d a f c
gh	 g h
gijje	 g i j j e
bcdiccja	 b c d i c c j a
fbhch	 f b h c h
hfijgd	 h f i j g d
aejd	 a e j d
ccjjhab	 c c j j h a b
jdhdcg	 j d h d c g
dgic	 d g i c
ifiibgic	 i f i i b g i c
aab	 a a b
ffgjcfifc	 f f g j c f i f c
efige	 e f i g e
bbjgb	 b b j g b
dejfecf	 d e j f e c f
eghi	 e g h i
dedehcdcc	 d e d e h c d c c
fh	 f h
hijbcd	 h i j b c d
igdafcfhi	 i g d a f c f h i
bech	 b e c h
jagfhah	 j a g f h a h
ebedjegh	 e b e d j e g h
cjf	 c j f
bahfifc	 b a h f i f c
dfecacbij	 d f e c a c b i j
haegjfa	 h a e g j f a
ca	 c a
bd	 b d
fd	 f d
idejh	 i d e j h
gdbdabi	 g d b d a b i
ifecacahc	 i f e c a c a h c
bbb	 b b b
gjhija	 g j h i j a
jfj	 j f j
gibjcafh	 g i b j c a f h
hgija	 h g i j a
ahhe	 a h h e
edicg	 e d i c g
fjdiecggi	 f j d i e c g g i
af	 a f
gb	 g b
dhcb	 d h c b
dghbb	 d g h b b
ighgci	 i g h g c i
jh	 j h
gebafiaah	 g e b a f i a a h
aejc	 a e j c
dejh	 d e j h
jjjha	 j j j h a
ebh	 e b h
iegf	 i e g f
hidjehjhf	 h i d j e h j h f
jbjhf	 j b j h f
bfbb	 b f b b
eca	 e c a
feiddcb	 f e i d d c b
dacbcbgid	 d a c b c b g i d
fb	 f b
jbdbci	 j b d b c i
gcje	 g c j e
iejfdedce	 i e j f d e d c e
ceddgfd	 c e d d g f d
jjb	 j j b
bc	 b c
dgigghcc	 d g i g g h c c
bcjfddf	 b c j f d d f
fei	 f e i
iaa	 i a a
heaeb	 h e a e b
ccicjjbgj	 c c i c j j b g j
cb	 c b
icfae	 i c f a e
jjfghfggh	 j j f g h f g g h
ibef	 i b e f
jefbghfhe	 j e f b g h f h e
dda	 d d a
fii	 f i i
bchf	 b c h f
agegjf	 a g e g j f
ffji	 f f j i
ffag	 f f a g
ebbdgabe	 e b b d g a b e
deahacb	 d e a h a c b
cfgjffjg	 c f g j f f j g
bfdid	 b f d i d
ghcdffce	 g h c d f f c e
cdeib	 c d e i b
gdbe	 g d b e
ee	 e e
aicabhehh	 a i c a b h e h h
iaddcijgb	 i a d d c i j g b
jhdjaj	 j h d j a j
cdedfabcg	 c d e d f a b c g
jcig	 j c i g
cecjadfa	 c e c j a d f a
faidgih	 f a i d g i h
eidf	 e i d f
aah	 a a h
iei	 i e i
ibcieg	 i b c i e g
gaej	 g a e j
ibfh	 i b f h
dfhb	 d f h b
ji	 j i
hah	 h a h
ehd	 e h d
cbfbidafj	 c b f b i d a f j
djfdfgi	 d j f d f g i
dfhea	 d f h e a
hjjchciff	 h j j c h c i f f
geibadc	 g e i b a d c
ffi	 f f i
eefief	 e e f i e f
ghi	 g h i
gadegie	 g a d e g i e
ebgaacbdi	 e b g a a c b d i
cjfibhh	 c j f i b h h
gha	 g h a
ccjjch	 c c j j c h
ccecd	 c c e c d
ai	 a i
cgjbeid	 c g j b e i d
jccehcbdj	 j c c e h c b d j
dfcj	 d f c j
adfiicag	 a d f i i c a g
cbf	 c b f
jfj	 j f j
jhc	 j h c
gbiiiafa	 g b i i i a f a
adc	 a d c
baeihiab	 b a e i h i a b
hebd	 h e b d
gacibcjb	 g a c i b c j b
hfid	 h f i d
jdje	 j d j e
ebggbb	 e b g g b b
fd	 f d
hdaa	 h d a a
degg	 d e g g
afdca	 a f d c a
ffdgc	 f f d g c
ifjce	 i f j c e
fb	 f b
cjg	 c j g
hfabgce	 h f a b g c e
daidf	 d a i d f
dhejd	 d h e j d
ga	 g a
ecfbhgdba	 e c f b h g d b a
haheef	 h a h e e f
hjdgffg	 h j d g f f g
fbjaehhj	 f b j a e h h j
jbhdcdh	 j b h d c d h
ide	 i d e
ijfjh	 i j f j h
baagfih	 b a a g f i h
cai	 c a i
jejhcjddc	 j e j h c j d d c
ggij	 g g i j
idcbd	 i d c b d
hidgaida	 h i d g a i d a
jcifdadh	 j c i f d a d h
jebfbihd	 j e b f b i h d
ef	 e f
ddcidcg	 d d c i d c g
djeef	 d j e e f
hfebdfbbe	 h f e b d f b b e
ehdaijc	 e h d a i j c
aeg	 a e g
cdd	 c d d
bh	 b h
ddgiae	 d d g i a e
ehbgagaig	 e h b g a g a i g
iddabe	 i d d a b e
fbfcgddg	 f b f c g d d g
cdghiei	 c d g h i e i
eg	 e g
jjfajgdc	 j j f a j g d c
chiha	 c h i h a
jeidcb	 j e i d c b
jcihhif	 j c i h h i f
ifihi	 i f i h i
jcajfcfj	 j c a j f c f j
gjdhahih	 g j d h a h i h
ifaebdgjb	 i f a e b d g j b
faj	 f a j
ahfhbfai	 a h f h b f a i
ihdbe	 i h d b e
ehdag	 e h d a g
bhdgicgeg	 b h d g i c g e g
jigicabd	 j i g i c a b d
bgjdja	 b g j d j a
daee	 d a e e
cagbfggd	 c a g b f g g d
gchfa	 g c h f a
ig	 i g
habfgfie	 h a b f g f i e
dffdbefdh	 d f f d b e f d h
agg	 a g g
gfbaiih	 g f b a i i h
fjdj	 f j d j
gdchdb	 g d c h d b
dieic	 d i e i c
fgbcc	 f g b c c
ebbjfji	 e b b j f j i
cechdj	 c e c h d j
gbghihbfd	 g b g h i h b f d
fbj	 f b j
difhcchh	 d i f h c c h h
ihfcjae	 i h f c j a e
dhfegedef	 d h f e g e d e f
dhhahhdf	 d h h a h h d f
aied	 a i e d
cf	 c f
fdia	 f d i a
hjac	 h j a c
icifahb	 i c i f a h b
bc	 b c
ifbcbfg	 i f b c b f g
edeec	 e d e e c
ia	 i a
da	 d a
ec	 e c
eecddda	 e e c d d d a
jdjiahj	 j d j i a h j
abdcd	 a b d c d
eeaigf	 e e a i g f
fejfg	 f e j f g
jb	 j b
jhi	 j h i
ajffiafg	 a j f f i a f g
fjcjcj	 f j c j c j
dfiaedef	 d f i a e d e f
giicdbaa	 g i i c d b a a
abgbffhj	 a b g b f f h j
fjhi	 f j h i
abd	 a b d
gafi	 g a f i
hfhdijici	 h f h d i j i c i
hh	 h h
ggb	 g g b
bdjjbf	 b d j j b f
adfefjeh	 a d f e f j e h
aggfa	 a g g f a
ffefda	 f f e f d a
bcefcei	 b c e f c e i
iaeijah	 i a e i j a h
fbejeiji	 f b e j e i j i
cdighci	 c d i g h c i
cdgajf	 c d g a j f
jcibfe	 j c i b f e
bj	 b j
dgigfh	 d g i g f h
cfjiicb	 c f j i i c b
gcagd	 g c a g d
icdjficbe	 i c d j f i c b e
daagjbhe	 d a a g j b h e
bagh	 b a g h
dfcfi	 d f c f i
ebggf	 e b g g f
dicij	 d i c i j
cec	 c e c
edhgdghji	 e d h g d g h j i
ba	 b a
gcgidhg	 g c g i d h g
cgi	 c g i
jhjg	 j h j g
hddfg	 h d d f g
bdh	 b d h
faffiedai	 f a f f i e d a i
aeaj	 a e a j
ei	 e i
agdjfh	 a g d j f h
ejh	 e j h
aaaefa	 a a a e f a
fdcdgfc	 f d c d g f c
fdiaej	 f d i a e j
ibfjc	 i b f j c
bacejg	 b a c e j g
cafbchdja	 c a f b c h d j a
fc	 f c
ehjea	 e h j e a
iib	 i i b
bcidci	 b c i d c i
gaijegii	 g a i j e g i i
eidefb	 e i d e f b
fhhidbji	 f h h i d b j i
gadhafa	 g a d h a f a
gbicegfb	 g b i c e g f b
ijdfb	 i j d f b
aahfheh	 a a h f h e h
afj	 a f j
ijgdajdac	 i j g d a j d a c
bhdiff	 b h d i f f
jejghefcf	 j e j g h e f c f
bg	 b g
fi	 f i
ch	 c h
ad	 a d
effhdhbif	 e f f h d h b i f
cahjebdij	 c a h j e b d i j
fegibdg	 f e g i b d g
bfaab	 b f a a b
dgihadebg	 d g i h a d e b g
beibddif	 b e i b d d i f
ajbfhaddh	 a j b f h a d d h
bhia	 b h i a
dec	 d e c
ejhfjgb	 e j h f j g b
iacafbbbb	 i a c a f b b b b
dhcjjde	 d h c j j d e
eedc	 e e d c
cae	 c a e
cgffad	 c g f f a d
egec	 e g e c
ejiffjgie	 e j i f f j g i e
aeefji	 a e e f j i
igebgd	 i g e b g d
cfhhe	 c f h h e
afcadib	 a f c a d i b
be	 b e
jgeffeaea	 j g e f f e a e a
jchfeb	 j c h f e b
jd	 j d
hjfieffbi	 h j f i e f f b i
cfgffg	 c f g f f g
bjc	 b j c
gdhjidi	 g d h j i d i
gjfejgj	 g j f e j g j
aedb	 a e d b
fghfjjci	 f g h f j j c i
ibcifeeid	 i b c i f e e i d
dahihc	 d a h i h c
ijigjcebd	 i j i g j c e b d
hjf	 h j f
feejhi	 f e e j h i
idgc	 i d g c
bec	 b e c
hb	 h b
ibeahebb	 i b e a h e b b
eifdcbj	 e i f d c b j
ihjad	 i h j a d
jachcdj	 j a c h c d j
efifbce	 e f i f b c e
bcaiegf	 b c a i e g f
aeaa	 a e a a
hbhbjbga	 h b h b j b g a
acijhb	 a c i j h b
fbdhhafj	 f b d h h a f j
cacbbibia	 c a c b b i b i a
ifghc	 i f g h c
ce	 c e
if	 i f
jcjd	 j c j d
ijfgfihj	 i j f g f i h j
jfa	 j f a
dedbjg	 d e d b j g
hhiabfif	 h h i a b f i f
eeggc	 e e g g c
aabb	 a a b b
bfcbhff	 b f c b h f f
edbagigh	 e d b a g i g h
ehcdabchc	 e h c d a b c h c
abe	 a b e
cbjc	 c b j c
jabhia	 j a b h i a
bi	 b i
ffdafb	 f f d a f b
af	 a f
gjdcfbadb	 g j d c f b a d b
de	 d e
fbid	 f b i d
ibcdhcg	 i b c d h c g
bejc	 b e j c
dbbgcbhg	 d b b g c b h g
bajbhhh	 b a j b h h h
jdijhabd	 j d i j h a b d
faac	 f a a c
cagfdaj	 c a g f d a j
aibicef	 a i b i c e f
iiib	 i i i b
iif	 i i f
chbjiicc	 c h b j i i c c
higbhbidd	 h i g b h b i d d
ihidcbc	 i h i d c b c
ebbdfc	 e b b d f c
gi	 g i
feigbbhh	 f e i g b b h h
faghhjgba	 f a g h h j g b a
jagdcehed	 j a g d c e h e d
ihg	 i h g
jaadf	 j a a d f
hahdebbhg	 h a h d e b b h g
cfje	 c f j e
idif	 i d i f
dahai	 d a h a i
jdafiehc	 j d a f i e h c
ghdfbcbd	 g h d f b c b d
ceiecbc	 c e i e c b c
jbcdccib	 j b c d c c i b
gcc	 g c c
bicidcd	 b i c i d c d
jjfi	 j j f i
djaijfj	 d j a i j f j
gfhdgced	 g f h d g c e d
hejidbe	 h e j i d b e
gcifhcbd	 g c i f h c b d
dhcgeh	 d h c g e h
jb	 j b
aceggchc	 a c e g g c h c
hfi	 h f i
jdedb	 j d e d b
biihffde	 b i i h f f d e
hjiac	 h j i a c
fgjfhdgd	 f g j f h d g d
djchiiib	 d j c h i i i b
hfjj	 h f j j
igjh	 i g j h
gg	 g g
dbfgiihf	 d b f g i i h f
eieefbai	 e i e e f b a i
ciijah	 c i i j a h
dgdbecih	 d g d b e c i h
ieh	 i e h
ecdhd	 e c d h d
fjcbcf	 f j c b c f
ga	 g a
accihabcc	 a c c i h a b c c
dghedjdhe	 d g h e d j d h e
iiafd	 i i a f d
hfae	 h f a e
igjhdbea	 i g j h d b e a
dic	 d i c
hhd	 h h d
cjhhhcjc	 c j h h h c j c
dbjfihjbd	 d b j f i h j b d
bbf	 b b f
gehia	 g e h i a
gehda	 g e h d a
ficgc	 f i c g c
aefaje	 a e f a j e
dabaicd	 d a b a i c d
chjjhj	 c h j j h j
igabic	 i g a b i c
acddijff	 a c d d i j f f
haheabbdh	 h a h e a b b d h
idgha	 i d g h a
ffaaadja	 f f a a a d j a
jfigc	 j f i g c
be	 b e
efag	 e f a g
gdcjdc	 g d c j d c
edefhbc	 e d e f h b c
gd	 g d
bgdcaghji	 b g d c a g h j i
bjfcb	 b j f c b
bdbh	 b d b h
ab	 a b
ddcdajhif	 d d c d a j h i f
jaefgebbj	 j a e f g e b b j
cd	 c d
ifgji	 i f g j i
ej	 e j
ccc	 c c c
ghg	 g h g
acbci	 a c b c i
eeadc	 e e a d c
gcjieacgf	 g c j i e a c g f
abbbgbe	 a b b b g b e
ebdhiech	 e b d h i e c h
jigjaaffe	 j i g j a a f f e
jjiefjj	 j j i e f j j
bfeecac	 b f e e c a c
fhfij	 f h f i j
fea	 f e a
ahiahdegg	 a h i a h d e g g
gcjb	 g c j b
hjcccgh	 h j c c c g h
ig	 i g
hiiiedjj	 h i i i e d j j
ahafhg	 a h a f h g
gffcfhhb	 g f f c f h h b
cfcjigadi	 c f c j i g a d i
dha	 d h a
jebfgg	 j e b f g g
dhieefde	 d h i e e f d e
fddhjibah	 f d d h j i b a h
ghfab	 g h f a b
ich	 i c h
jceda	 j c e d a
fc	 f c
dcjjjj	 d c j j j j
fhf	 f h f
gcg	 g c g
begfg	 b e g f g
cchfhd	 c c h f h d
hb	 h b
cj	 c j
higb	 h i g b
dgbg	 d g b g
ac	 a c
jeee	 j e e e
egbj	 e g b j
fce	 f c e
db	 d b
dhfi	 d h f i
bagijcde	 b a g i j c d e
cgijc	 c g i j c
ejdbjchb	 e j d b j c h b
jhj	 j h j
fa	 f a
dgdeb	 d g d e b
ffg	 f f g
cffi	 c f f i
hffgacj	 h f f g a c j
eicdgi	 e i c d g i
ifb	 i f b
hadif	 h a d i f
jeacagac	 j e a c a g a c
bjdce	 b j d c e
hieah	 h i e a h
ffa	 f f a
gdeiai	 g d e i a i
jhgh	 j h g h
dfjccjbgf	 d f j c c j b g f
ijhdfegg	 i j h d f e g g
fgajag	 f g a j a g
bbc	 b b c
edeefedhi	 e d e e f e d h i
hbha	 h b h a
ebee	 e b e e
cdbed	 c d b e d
eig	 e i g
db	 d b
dcccefce	 d c c c e f c e
iag	 i a g
bdjdbg	 b d j d b g
hibb	 h i b b
edj	 e d j
jbjgfhcja	 j b j g f h c j a
didgi	 d i d g i
dfe	 d f e
ie	 i e
acihfdai	 a c i h f d a i
agjhegj	 a g j h e g j
cjah	 c j a h
egfbcdhi	 e g f b c d h i
ejcagafac	 e j c a g a f a c
gghjcj	 g g h j c j
edbijec	 e d b i j e c
aa	 a a
cbhea	 c b h e a
cijgbajdg	 c i j g b a j d g
fcee	 f c e e
fd	 f d
dfjjadb	 d f j j a d b
jj	 j j
hhd	 h h d
gigcgd	 g i g c g d
gihjjaibc	 g i h j j a i b c
ahfhfid	 a h f h f i d
jjaab	 j j a a b
bbehic	 b b e h i c
dbaajd	 d b a a j d
bfbge	 b f b g e
jjccecace	 j j c c e c a c e
ehi	 e h i
jab	 j a b
hjaejbdde	 h j a e j b d d e
efhffh	 e f h f f h
fc	 f c
edeghjj	 e d e g h j j
djdhe	 d j d h e
jbdchi	 j b d c h i
fcecjfj	 f c e c j f j
jg	 j g
djhgg	 d j h g g
bihc	 b i h c
fe	 f e
da	 d a
cdgec	 c d g e c
daihgff	 d a i h g f f
fefidih	 f e f i d i h
ijdfehid	 i j d f e h i d
ghdajbdd	 g h d a j b d d
fgjib	 f g j i b
eh	 e h
acfah	 a c f a h
geh	 g e h
ccaibb	 c c a i b b
hdeccaib	 h d e c c a i b
agjhie	 a g j h i e
ggbjbdgca	 g g b j b d g c a
ahdba	 a h d b a
adaicfd	 a d a i c f d
ccchf	 c c c h f
hahfcff	 h a h f c f f
fcaggedf	 f c a g g e d f
fbeggcgd	 f b e g g c g d
gjed	 g j e d
bf	 b f
ibbcbaf	 i b b c b a f
efcaihhd	 e f c a i h h d
faedjgjcg	 f a e d j g j c g
ia	 i a
ihacijiab	 i h a c i j i a b
hjefa	 h j e f a
jeadf	 j e a d f
hca	 h c a
jjjjfe	 j j j j f e
fii	 f i i
ejccaaeja	 e j c c a a e j a
cghdb	 c g h d b
ggchj	 g g c h j
ejigci	 e j i g c i
acigehdb	 a c i g e h d b
hbbg	 h b b g
gfbadcc	 g f b a d c c
bgaaih	 b g a a i h
hhbibi	 h h b i b i
eeffbe	 e e f f b e
jehebfhh	 j e h e b f h h
jb	 j b
eabecfg	 e a b e c f g
aidcb	 a i d c b
gjiai	 g j i a i
baag	 b a a g
dcf	 d c f
hfcjfd	 h f c j f d
hdfegjcjd	 h d f e g j c j d
cahi	 c a h i
ba	 b a
feieafbci	 f e i e a f b c i
gf	 g f
gc	 g c
gaaegfegd	 g a a e g f e g d
jjhaga	 j j h a g a
gdji	 g d j i
hfiafgg	 h f i a f g g
fga	 f g a
hcjie	 h c j i e
gafabjbj	 g a f a b j b j
deeabb	 d e e a b b
ehfg	 e h f g
cjbjdd	 c j b j d d
eeib	 e e i b
gcfdh	 g c f d h
gccab	 g c c a b
cddbhd	 c d d b h d
jiagg	 j i a g g
abjbhiaif	 a b j b h i a i f
ebebfj	 e b e b f j
fdicdjgde	 f d i c d j g d e
aiccehe	 a i c c e h e
ceb	 c e b
bgjaajf	 b g j a a j f
bjghchab	 b j g h c h a b
hjj	 h j j
hgffihjci	 h g f f i h j c i
cd	 c d
eigiee	 e i g i e e
ad	 a d
bd	 b d
ibcfd	 i b c f d
jaef	 j a e f
bda	 b d a
ii	 i i
ahj	 a h j
je	 j e
bbeef	 b b e e f
gf	 g f
jb	 j b
dagjdi	 d a g j d i
bi	 b i
hjc	 h j c
hfiaihbbc	 h f i a i h b b c
ihadged	 i h a d g e d
ggjd	 g g j d
ibbgbj	 i b b g b j
eiabhcagh	 e i a b h c a g h
fi	 f i
aahfjj	 a a h f j j
hjh	 h j h
egaeg	 e g a e g
affij	 a f f i j
gch	 g c h
hdagebc	 h d a g e b c
aihj	 a i h j
ecj	 e c j
eggchcija	 e g g c h c i j a
geghjj	 g e g h j j
fb	 f b
bijaba	 b i j a b a
heba	 h e b a
bjjdhag	 b j j d h a g
hiifj	 h i i f j
afecbd	 a f e c b d
ifgafj	 i f g a f j
dhb	 d h b
dghhcba	 d g h h c b a
ibajga	 i b a j g a
chjijciih	 c h j i j c i i h
jbbd	 j b b d
hahi	 h a h i
gjaeidge	 g j a e i d g e
iecdb	 i e c d b
hfebdegj	 h f e b d e g j
fegbfihj	 f e g b f i h j
decgbhhb	 d e c g b h h b
eeidjbedg	 e e i d j b e d g
fagbc	 f a g b c
de	 d e
jchagdibg	 j c h a g d i b g
hiihjaci	 h i i h j a c i
jbed	 j b e d
hiih	 h i i h
ec	 e c
bijagi	 b i j a g i
bdddee	 b d d d e e
ifbdi	 i f b d i
aiggacjc	 a i g g a c j c
ei	 e i
dcdbbbfi	 d c d b b b f i
caeg	 c a e g
dgje	 d g j e
hdfdgca	 h d f d g c a
iifcj	 i i f c j
cej	 c e j
jehie	 j e h i e
df	 d f
jehfgg	 j e h f g g
cf	 c f
bi	 b i
ace	 a c e
bibihjb	 b i b i h j b
ade	 a d e
ejffj	 e j f f j
bgdich	 b g d i c h
bdcajjag	 b d c a j j a g
jad	 j a d
eed	 e e d
bdcdfied	 b d c d f i e d
aefhhgfdc	 a e f h h g f d c
eficcjcjb	 e f i c c j c j b
fgaf	 f g a f
hd	 h d
dd	 d d
cib	 c i b
eif	 e i f
igieajf	 i g i e a j f
dhfdgcegj	 d h f d g c e g j
ecfdgaci	 e c f d g a c i
djf	 d j f
jj	 j j
jceehf	 j c e e h f
dfc	 d f c
eaaic	 e a a i c
efegg	 e f e g g
ih	 i h
gdjbfc	 g d j b f c
ba	 b a
aafcg	 a a f c g
efe	 e f e
ffeg	 f f e g
higac	 h i g a c
dffah	 d f f a h
igfbga	 i g f b g a
jaegbbc	 j a e g b b c
bcaadbe	 b c a a d b e
gjhbd	 g j h b d
ehcgc	 e h c g c
ifdaihch	 i f d a i h c h
ccbe	 c c b e
ja	 j a
eib	 e i b
bfcgddbah	 b f c g d d b a h
ghjge	 g h j g e
ibeh	 i b e h
cgcid	 c g c i d
hjgg	 h j g g
ghcach	 g h c a c h
ffcjja	 f f c j j a
ibei	 i b e i
dac	 d a c
gcijaaj	 g c i j a a j
jibidij	 j i b i d i j
eeij	 e e i j
jai	 j a i
fajf	 f a j f
ifiebfig	 i f i e b f i g
dbffgaj	 d b f f g a j
aee	 a e e
hehhefgf	 h e h h e f g f
ecd	 e c d
ecfiegie	 e c f i e g i e
caaej	 c a a e j
jjjghf	 j j j g h f
jgiigajaf	 j g i i g a j a f
ddbiidj	 d d b i i d j
haai	 h a a i
dccjhfg	 d c c j h f g
fjd	 f j d
hga	 h g a
ijjbfc	 i j j b f c
jacgagcb	 j a c g a g c b
jgaeiga	 j g a e i g a
he	 h e
ib	 i b
cicjbae	 c i c j b a e
ebfgffgd	 e b f g f f g d
jbchhdebe	 j b c h h d e b e
dfcga	 d f c g a
fg	 f g
hafc	 h a f c
fbce	 f b c e
bfajcdfjd	 b f a j c d f j d
baj	 b a j
dg	 d g
gdac	 g d a c
cgehaacce	 c g e h a a c c e
cigabch	 c i g a b c h
aaj	 a a j
diahfifc	 d i a h f i f c
iccjfgdbc	 i c c j f g d b c
ihjgcc	 i h j g c c
gabb	 g a b b
egibhdga	 e g i b h d g a
gcififb	 g c i f i f b
adh	 a d h
gjfiddhh	 g j f i d d h h
abbjgajij	 a b b j g a j i j
gihfjfeg	 g i h f j f e g
ggccgeah	 g g c c g e a h
fhfbcfhfg	 f h f b c f h f g
eacfc	 e a c f c
giichche	 g i i c h c h e
ggheiehg	 g g h e i e h g
gbdaidg	 g b d a i d g
ijbffhea	 i j b f f h e a
jcedbihb	 j c e d b i h b
fc	 f c
ciaa	 c i a a
jecehbfcb	 j e c e h b f c b
fdf	 f d f
gd	 g d
giii	 g i i i
cbb	 c b b
gdhbhja	 g d h b h j a
baaj	 b a a j
gdebdgcgd	 g d e b d g c g d
ibefbjc	 i b e f b j c
jfjideige	 j f j i d e i g e
ciadchjfc	 c i a d c h j f c
jjeieiife	 j j e i e i i f e
dhadgj	 d h a d g j
gjhj	 g j h j
fefebdhc	 f e f e b d h c
bh	 b h
fghe	 f g h e
igeajecd	 i g e a j e c d
dgibieajb	 d g i b i e a j b
aahccc	 a a h c c c
ahgfefg	 a h g f e f g
faagdihdh	 f a a g d i h d h
jb	 j b
ebdi	 e b d i
babiic	 b a b i i c
geij	 g e i j
hahhghdgh	 h a h h g h d g h
jdificgf	 j d i f i c g f
cd	 c d
daaccbdhb	 d a a c c b d h b
jbgceeaj	 j b g c e e a j
bbff	 b b f f
cfcg	 c f c g
jdeh	 j d e h
ehigjjh	 e h i g j j h
fefhajaa	 f e f h a j a a
bhaea	 b h a e a
fhcffc	 f h c f f c
aghdjgj	 a g h d j g j
ijhejfhh	 i j h e j f h h
heh	 h e h
jbjdebbb	 j b j d e b b b
gd	 g d
fahacbbjb	 f a h a c b b j b
ghebcdhf	 g h e b c d h f
dibdfebbh	 d i b d f e b b h
ehafiai	 e h a f i a i
dga	 d g a
ajhffjdfh	 a j h f f j d f h
gj	 g j
ehjc	 e h j c
abajcjidc	 a b a j c j i d c
aadeigic	 a a d e i g i c
bbijae	 b b i j a e
iia	 i i a
jfajege	 j f a j e g e
ih	 i h
ijga	 i j g a
ac	 a c
ddafjcbad	 d d a f j c b a d
jigdejghf	 j i g d e j g h f
ejdhca	 e j d h c a
cfffhicc	 c f f f h i c c
fhhih	 f h h i h
ihddfghcg	 i h d d f g h c g
dggb	 d g g b
ac	 a c
egj	 e g j
cdbc	 c d b c
fc	 f c
ada	 a d a
efjcafid	 e f j c a f i d
fgeieghgg	 f g e i e g h g g
eijgged	 e i j g g e d
dbbggebga	 d b b g g e b g a
ie	 i e
fej	 f e j
ehjgd	 e h j g d
ba	 b a
cbhcdcej	 c b h c d c e j
fabce	 f a b c e
jehfc	 j e h f c
dejecf	 d e j e c f
ee	 e e
ech	 e c h
fjifhah	 f j i f h a h
gbefd	 g b e f d
ehbhai	 e h b h a i
ghd	 g h d
bif	 b i f
agggiia	 a g g g i i a
bfaeb	 b f a e b
fhgchfc	 f h g c h f c
cbfj	 c b f j
ghhie	 g h h i e
dh	 d h
dg	 d g
hjfdjjf	 h j f d j j f
ebccfi	 e b c c f i
hjdidhae	 h j d i d h a e
cdgahbbif	 c d g a h b b i f
chgccg	 c h g c c g
cggfi	 c g g f i
ccjhafcii	 c c j h a f c i i
idibjfb	 i d i b j f b
adhdgggff	 a d h d g g g f f
eafib	 e a f i b
cgjci	 c g j c i
edfbdcbid	 e d f b d c b i d
icigi	 i c i g i
egchhc	 e g c h h c
bg	 b g
afchcjaa	 a f c h c j a a
dfgif	 d f g i f
hadfijd	 h a d f i j d
icbhhei	 i c b h h e i
cj	 c j
ghji	 g h j i
fcbefffa	 f c b e f f f a
abj	 a b j
ac	 a c
fhechejd	 f h e c h e j d
cjjjjh	 c j j j j h
hddaeic	 h d d a e i c
jfhbggc	 j f h b g g c
aiedc	 a i e d c
adb	 a d b
abijdhca	 a b i j d h c a
eggehfb	 e g g e h f b
ihajjedd	 i h a j j e d d
gjjihaja	 g j j i h a j a
gae	 g a e
fcajaifc	 f c a j a i f c
jf	 j f
fhba	 f h b a
cggeffibh	 c g g e f f i b h
gfcdejeg	 g f c d e j e g
ehhffefcb	 e h h f f e f c b
egiga	 e g i g a
ibdgddhd	 i b d g d d h d
afjad	 a f j a d
cg	 c g
ddacedgee	 d d a c e d g e e
ahhfda	 a h h f d a
ch	 c h
fbdbj	 f b d b j
fbde	 f b d e
dfba	 d f b a
ghdcc	 g h d c c
jjbdehid	 j j b d e h i d
iheigc	 i h e i g c
hgd	 h g d
hj	 h j
hijhgd	 h i j h g d
ajihdajbf	 a j i h d a j b f
bfafjfigf	 b f a f j f i g f
aicifeg	 a i c i f e g
hgccc	 h g c c c
dejafa	 d e j a f a
fdiccbgb	 f d i c c b g b
aeci	 a e c i
gdfbg	 g d f b g
ia	 i a
bghihghj	 b g h i h g h j
ig	 i g
ihajgicg	 i h a j g i c g
dfj	 d f j
ffgf	 f f g f
aaib	 a a i b
behc	 b e h c
jgd	 j g d
cgjib	 c g j i b
ggigahd	 g g i g a h d
ebefe	 e b e f e
fdef	 f d e f
jhgcd	 j h g c d
adbje	 a d b j e
bjcfagggb	 b j c f a g g g b
gehahj	 g e h a h j
gbjfe	 g b j f e
ijjggfchc	 i j j g g f c h c
caj	 c a j
dcgccd	 d c g c c d
gjjahi	 g j j a h i
dejab	 d e j a b
bjhae	 b j h a e
ihac	 i h a c
jjihihei	 j j i h i h e i
jhfchh	 j h f c h h
ha	 h a
cbcdh	 c b c d h
hded	 h d e d
jbg	 j b g
ebghf	 e b g h f
ifjg	 i f j g
eb	 e b
bbhi	 b b h i
hhibfccfa	 h h i b f c c f a
cdbfbcggd	 c d b f b c g g d
gfji	 g f j i
chdh	 c h d h
bf	 b f
ei	 e i
bidiacf	 b i d i a c f
daigjhchb	 d a i g j h c h b
fgjbah	 f g j b a h
bebjbjf	 b e b j b j f
ddihjfceb	 d d i h j f c e b
bgh	 b g h
jhdg	 j h d g
gfibf	 g f i b f
eg	 e g
bjjei	 b j j e i
jdjc	 j d j c
eidj	 e i d j
ff	 f f
ga	 g a
dfijcdd	 d f i j c d d
ibgjhia	 i b g j h i a
ea	 e a
eb	 e b
hfaicc	 h f a i c c
hgbefg	 h g b e f g
fgg	 f g g
eeejja	 e e e j j a
ccciheje	 c c c i h e j e
cjhcj	 c j h c j
igebabeig	 i g e b a b e i g
bbfhjj	 b b f h j j
haie	 h a i e
jiach	 j i a c h
dfibecb	 d f i b e c b
ifegajaad	 i f e g a j a a d
dfjbjic	 d f j b j i c
ci	 c i
dbi	 d b i
jf	 j f
hacgaghec	 h a c g a g h e c
ceceja	 c e c e j a
dggafa	 d g g a f a
bhf	 b h f
abefag	 a b e f a g
ch	 c h
ehd	 e h d
egjgef	 e g j g e f
ci	 c i
ehghjhae	 e h g h j h a e
chaeeg	 c h a e e g
jbgfa	 j b g f a
gji	 g j i
hbadiiccf	 h b a d i i c c f
ifabd	 i f a b d
dcdb	 d c d b
dbhddabh	 d b h d d a b h
jcahdcecf	 j c a h d c e c f
ijhgh	 i j h g h
hc	 h c
hhaea	 h h a e a
jbgi	 j b g i
jhhddh	 j h h d d h
eid	 e i d
bhibfi	 b h i b f i
aiad	 a i a d
ejjei	 e j j e i
ecfchb	 e c f c h b
ehb	 e h b
dahcad	 d a h c a d
cdeafi	 c d e a f i
aged	 a g e d
gjbghh	 g j b g h h
eibdbg	 e i b d b g
fa	 f a
ecbcc	 e c b c c
jhbb	 j h b b
ff	 f f
idj	 i d j
gfh	 g f h
beacbegeh	 b e a c b e g e h
gah	 g a h
da	 d a
efhciie	 e f h c i i e
djdeafad	 d j d e a f a d
hhiccehc	 h h i c c e h c
iica	 i i c a
cdf	 c d f
eabcjbfdh	 e a b c j b f d h
iiciccd	 i i c i c c d
jj	 j j
hdbbehib	 h d b b e h i b
eh	 e h
bacb	 b a c b
fabiiigc	 f a b i i i g c
ib	 i b
aafjg	 a a f j g
cffidbbbd	 c f f i d b b b d
didae	 d i d a e
dbhjdh	 d b h j d h
cif	 c i f
ij	 i j
hdh	 h d h
dfgghadg	 d f g g h a d g
bgjhi	 b g j h i
hcibi	 h c i b i
bbjfc	 b b j f c
cibdahjcc	 c i b d a h j c c
bfe	 b f e
jedhhgj	 j e d h h g j
gcbhc	 g c b h c
bed	 b e d
caej	 c a e j
igbe	 i g b e
fdb	 f d b
hejgif	 h e j g i f
bee	 b e e
ghf	 g h f
cjd	 c j d
eedjfaaf	 e e d j f a a f
iagd	 i a g d
djb	 d j b
jbhcbei	 j b h c b e i
gaejjdc	 g a e j j d c
aibfd	 a i b f d
acgeecbb	 a c g e e c b b
hibgfafd	 h i b g f a f d
baiac	 b a i a c
dcgbedf	 d c g b e d f
daji	 d a j i
dhbgdfefd	 d h b g d f e f d
jc	 j c
fhjafc	 f h j a f c
ffehjb	 f f e h j b
gdfdca	 g d f d c a
dchjad	 d c h j a d
eccaj	 e c c a j
ade	 a d e
gffbfjg	 g f f b f j g
gabbf	 g a b b f
ajfgj	 a j f g j
ecagbh	 e c a g b h
ddgaefi	 d d g a e f i
dehcjdiec	 d e h c j d i e c
ahijj	 a h i j j
idgahij	 i d g a h i j
fb	 f b
eccacch	 e c c a c c h
ihejh	 i h e j h
cichcjbb	 c i c h c j b b
hijbdff	 h i j b d f f
chejih	 c h e j i h
aebf	 a e b f
ibdjaegi	 i b d j a e g i
ed	 e d
hecibj	 h e c i b j
cj	 c j
hhfigbicd	 h h f i g b i c d
fdgfjgbg	 f d g f j g b g
bbhif	 b b h i f
jd	 j d
jjedfig	 j j e d f i g
hfea	 h f e a
igcdjfgdg	 i g c d j f g d g
ihcfig	 i h c f i g
egfaa	 e g f a a
ijiccei	 i j i c c e i
eiejhgc	 e i e j h g c
agh	 a g h
hifcddgde	 h i f c d d g d e
hihdbafg	 h i h d b a f g
fjjhgfhhe	 f j j h g f h h e
ih	 i h
dda	 d d a
caihc	 c a i h c
cceef	 c c e e f
jj	 j j
adbcd	 a d b c d
ffahgice	 f f a h g i c e
dc	 d c
dhgc	 d h g c
aj	 a j
ajfieege	 a j f i e e g e
efab	 e f a b
ffafea	 f f a f e a
jh	 j h
fhbfggdb	 f h b f g g d b
jhahd	 j h a h d
cdhgifgbg	 c d h g i f g b g
hgchdgg	 h g c h d g g
gahaic	 g a h a i c
hgeca	 h g e c a
afegbjeee	 a f e g b j e e e
dajjb	 d a j j b
dhbaiajaj	 d h b a i a j a j
ddeeacgh	 d d e e a c g h
fdhcie	 f d h c i e
hfhci	 h f h c i
ijddhh	 i j d d h h
ghjcadejh	 g h j c a d e j h
gaheb	 g a h e b
dccbijee	 d c c b i j e e
bfg	 b f g
iei	 i e i
djcfdjcgg	 d j c f d j c g g
cchdb	 c c h d b
fjci	 f j c i
gifeegeh	 g i f e e g e h
daacehche	 d a a c e h c h e
jafbgfeib	 j a f b g f e i b
gaagj	 g a a g j
hee	 h e e
aeheegj	 a e h e e g j
jidbj	 j i d b j
acfhgjfih	 a c f h g j f i h
gfaibg	 g f a i b g
efdcc	 e f d c c
gcjjbdg	 g c j j b d g
ejgjjdfh	 e j g j j d f h
gi	 g i
hjdj	 h j d j
fejbdf	 f e j b d f
fiah	 f i a h
fjcjh	 f j c j h
ifgj	 i f g j
difi	 d i f i
bibacffjg	 b i b a c f f j g
hadfieef	 h a d f i e e f
gbj	 g b j
cjei	 c j e i
ahc	 a h c
hjigij	 h j i g i j
fcihfdbec	 f c i h f d b e c
caade	 c a a d e
iajdh	 i a j d h
ecgbgj	 e c g b g j
iehdacbaa	 i e h d a c b a a
bfc	 b f c
be	 b e
gehhgjcd	 g e h h g j c d
aa	 a a
ejef	 e j e f
ggf	 g g f
bjhci	 b j h c i
ajggdbgj	 a j g g d b g j
dggj	 d g g j
jig	 j i g
jagfhhi	 j a g f h h i
cfaifih	 c f a i f i h
baffi	 b a f f i
ibijijg	 i b i j i j g
hebeh	 h e b e h
bhjee	 b h j e e
fbffdhe	 f b f f d h e
hfdag	 h f d a g
dhhcgb	 d h h c g b
icd	 i c d
ci	 c i
gijaiaebc	 g i j a i a e b c
ghhg	 g h h g
jicjfbjef	 j i c j f b j e f
ccafe	 c c a f e
iahb	 i a h b
caagce	 c a a g c e
ejicjgd	 e j i c j g d
ffiaefgfe	 f f i a e f g f e
gggg	 g g g g
heaegja	 h e a e g j a
efabhhjgj	 e f a b h h j g j
iijie	 i i j i e
afiigfgf	 a f i i g f g f
cgfcfggj	 c g f c f g g j
gdgcadfe	 g d g c a d f e
abcfbcgb	 a b c f b c g b
ehcigachg	 e h c i g a c h g
icf	 i c f
ag	 a g
eedfhgdhg	 e e d f h g d h g
ecbibhcd	 e c b i b h c d
aa	 a a
ffcb	 f f c b
hbggjfaeb	 h b g g j f a e b
fbjdedgd	 f b j d e d g d
cefaach	 c e f a a c h
edcigjh	 e d c i g j h
eihd	 e i h d
adjgjh	 a d j g j h
ehci	 e h c i
jb	 j b
gci	 g c i
fg	 f g
cajjf	 c a j j f
bcfjci	 b c f j c i
jjj	 j j j
cfei	 c f e i
hfgbi	 h f g b i
jbfie	 j b f i e
ga	 g a
ejajabjf	 e j a j a b j f
bgbffb	 b g b f f b
bajiffaj	 b a j i f f a j
dddecbig	 d d d e c b i g
ajga	 a j g a
dbci	 d b c i
begdd	 b e g d d
hcacigcic	 h c a c i g c i c
hffbcibb	 h f f b c i b b
egjb	 e g j b
gieaaci	 g i e a a c i
gj	 g j
gcbghafje	 g c b g h a f j e
eebdg	 e e b d g
ifgaejgbj	 i f g a e j g b j
figd	 f i g d
dga	 d g a
hfjh	 h f j h
agfgda	 a g f g d a
edg	 e d g
icdgfjdef	 i c d g f j d e f
hfa	 h f a
cfiheh	 c f i h e h
decdedaj	 d e c d e d a j
dbhigbe	 d b h i g b e
ahdciddg	 a h d c i d d g
bffcacd	 b f f c a c d
gjh	 g j h
djfceaai	 d j f c e a a i
icabaci	 i c a b a c i
ggeaihfj	 g g e a i h f j
ehcbfii	 e h c b f i i
geg	 g e g
iffdegd	 i f f d e g d
jgcjfa	 j g c j f a
cidgj	 c i d g j
eiaa	 e i a a
dcdbh	 d c d b h
ei	 e i
edb	 e d b
djdabi	 d j d a b i
cgfgdeh	 c g f g d e h
ie	 i e
hj	 h j
adjihba	 a d j i h b a
hddbgbf	 h d d b g b f
bi	 b i
dd	 d d
cedc	 c e d c
ijhijh	 i j h i j h
idahjfh	 i d a h j f h
fj	 f j
ceee	 c e e e
dec	 d e c
cfhejcc	 c f h e j c c
ehdcd	 e h d c d
ghb	 g h b
diea	 d i e a
gbjieh	 g b j i e h
abhhc	 a b h h c
biggjhg	 b i g g j h g
jefaajfae	 j e f a a j f a e
dhc	 d h c
aidh	 a i d h
jjafcgi	 j j a f c g i
fcdfdb	 f c d f d b
hfagae	 h f a g a e
jibcfg	 j i b c f g
ejhia	 e j h i a
dcaa	 d c a a
fdd	 f d d
ejghaf	 e j g h a f
ghdjce	 g h d j c e
bebja	 b e b j a
cgebcf	 c g e b c f
hccc	 h c c c
cdj	 c d j
ddg	 d d g
bg	 b g
jici	 j i c i
gbbgaefc	 g b b g a e f c
gifjbhc	 g i f j b h c
jh	 j h
jfibbcjg	 j f i b b c j g
jdag	 j d a g
jjic	 j j i c
hic	 h i c
jcgicgh	 j c g i c g h
bde	 b d e
geha	 g e h a
ahedj	 a h e d j
icbbaejhf	 i c b b a e j h f
ei	 e i
ahchbi	 a h c h b i
bbdihhfbe	 b b d i h h f b e
icaifb	 i c a i f b
baa	 b a a
bic	 b i c
bjhf	 b j h f
egaadjbhj	 e g a a d j b h j
ecdc	 e c d c
jf	 j f
beghg	 b e g h g
ceecfchd	 c e e c f c h d
aj	 a j
cjjhgj	 c j j h g j
hih	 h i h
cacjb	 c a c j b
egjfb	 e g j f b
adf	 a d f
jeceh	 j e c e h
dibdba	 d i b d b a
ca	 c a
aiaaagcj	 a i a a a g c j
cadfjig	 c a d f j i g
ic	 i c
hbifajje	 h b i f a j j e
hcffj	 h c f f j
bg	 b g
ibaeb	 i b a e b
eb	 e b
jjg	 j j g
gabaga	 g a b a g a
gdjbehffh	 g d j b e h f f h
bbfhfadi	 b b f h f a d i
dcejeaggf	 d c e j e a g g f
ib	 i b
adifidi	 a d i f i d i
fafacj	 f a f a c j
hdcbchfjf	 h d c b c h f j f
ebeadb	 e b e a d b
afahffih	 a f a h f f i h
iedefjhcj	 i e d e f j h c j
gficbb	 g f i c b b
gigfahghe	 g i g f a h g h e
ed	 e d
iihbjba	 i i h b j b a
ceidaad	 c e i d a a d
ihiaig	 i h i a i g
edh	 e d h
fbcji	 f b c j i
dgce	 d g c e
hbhbbahj	 h b h b b a h j
ghf	 g h f
dihgcjaic	 d i h g c j a i c
eggcj	 e g g c j
hbdc	 h b d c
ghdjdc	 g h d j d c
idficfh	 i d f i c f h
ffbdd	 f f b d d
iidjb	 i i d j b
hfi	 h f i
jegeaacag	 j e g e a a c a g
ggiabeb	 g g i a b e b
eid	 e i d
ddej	 d d e j
fbc	 f b c
iibiggf	 i i b i g g f
hdifiehfd	 h d i f i e h f d
igi	 i g i
gci	 g c i
fgec	 f g e c
hdij	 h d i j
gif	 g i f
ab	 a b
ecc	 e c c
babd	 b a b d
ba	 b a
ccgegaj	 c c g e g a j
fj	 f j
id	 i d
fic	 f i c
aiafa	 a i a f a
hhgacf	 h h g a c f
egcbhicc	 e g c b h i c c
fgdj	 f g d j
ahcige	 a h c i g e
gafdccfea	 g a f d c c f e a
ihfihf	 i h f i h f
fcchie	 f c c h i e
dbd	 d b d
hddae	 h d d a e
fgggi	 f g g g i
hcdbfdcg	 h c d b f d c g
jheha	 j h e h a
gejhig	 g e j h i g
hheed	 h h e e d
hhf	 h h f
eadfbijjg	 e a d f b i j j g
fabdfe	 f a b d f e
dac	 d a c
fd	 f d
ehgfcbd	 e h g f c b d
iec	 i e c
cjffgi	 c j f f g i
bbfcjidg	 b b f c j i d g
bac	 b a c
dgihih	 d g i h i h
cae	 c a e
fgehdcgi	 f g e h d c g i
gcifjdd	 g c i f j d d
ahbd	 a h b d
aahdadf	 a a h d a d f
dcdfcfg	 d c d f c f g
heb	 h e b
dfieajjf	 d f i e a j j f
gbcbag	 g b c b a g
hgf	 h g f
cjjaahhf	 c j j a a h h f
efe	 e f e
cijfdcjdh	 c i j f d c j d h
ad	 a d
efhada	 e f h a d a
hc	 h c
cddf	 c d d f
hddfh	 h d d f h
hgebgifga	 h g e b g i f g a
cjb	 c j b
fb	 f b
he	 h e
ac	 a c
gdgdg	 g d g d g
chdgcbbad	 c h d g c b b a d
hajjiba	 h a j j i b a
aiafghga	 a i a f g h g a
gfidjheca	 g f i d j h e c a
cjae	 c j a e
gihaahaj	 g i h a a h a j
digejabb	 d i g e j a b b
cjdjbh	 c j d j b h
bibhfdib	 b i b h f d i b
cgghiidfd	 c g g h i i d f d
cfc	 c f c
hfgc	 h f g c
bcigijb	 b c i g i j b
diifhdjhb	 d i i f h d j h b
hfjfad	 h f j f a d
ebbhcj	 e b b h c j
eghjebghe	 e g h j e b g h e
ff	 f f
ee	 e e
abciecj	 a b c i e c j
diebfffg	 d i e b f f f g
bjj	 b j j
cbg	 c b g
daadeag	 d a a d e a g
fechehjif	 f e c h e h j i f
eebhceg	 e e b h c e g
hj	 h j
bdfccifdb	 b d f c c i f d b
bdecicde	 b d e c i c d e
icjdgj	 i c j d g j
ajbe	 a j b e
hjgci	 h j g c i
hjdgb	 h j d g b
jaf	 j a f
ggahd	 g g a h d
jjgagfdah	 j j g a g f d a h
abjd	 a b j d
dbcbe	 d b c b e
ghhf	 g h h f
bciehecc	 b c i e h e c c
djajbeib	 d j a j b e i b
jddiga	 j d d i g a
hebbgag	 h e b b g a g
dhj	 d h j
agaj	 a g a j
gacbc	 g a c b c
djfh	 d j f h
fcccff	 f c c c f f
ai	 a i
hahihch	 h a h i h c h
jhgccii	 j h g c c i i
cid	 c i d
ahfefbj	 a h f e f b j
edcaa	 e d c a a
fadd	 f a d d
ahbiegbb	 a h b i e g b b
gj	 g j
ich	 i c h
hage	 h a g e
iechff	 i e c h f f
jg	 j g
iih	 i i h
iabeg	 i a b e g
fga	 f g a
ig	 i g
aefdfih	 a e f d f i h
gd	 g d
afgibg	 a f g i b g
fdbhfiia	 f d b h f i i a
gehddebb	 g e h d d e b b
da	 d a
afjc	 a f j c
ibacdeghg	 i b a c d e g h g
bihbji	 b i h b j i
bfd	 b f d
fbhijcdcf	 f b h i j c d c f
fjebgcjh	 f j e b g c j h
chhedj	 c h h e d j
gcfjdffe	 g c f j d f f e
bjjfgg	 b j j f g g
dbagfaigd	 d b a g f a i g d
aid	 a i d
adejbbii	 a d e j b b i i
fbhcif	 f b h c i f
hfjhh	 h f j h h
hehhcie	 h e h h c i e
cb	 c b
eic	 e i c
hcdihdgai	 h c d i h d g a i
hhj	 h h j
ggegebe	 g g e g e b e
bfbgb	 b f b g b
gbbfhcghd	 g b b f h c g h d
ice	 i c e
eh	 e h
bdgijihfa	 b d g i j i h f a
hjj	 h j j
hb	 h b
efceag	 e f c e a g
ajg	 a j g
cdbciaei	 c d b c i a e i
fhb	 f h b
jgh	 j g h
ibfbdfid	 i b f b d f i d
jeecidcjh	 j e e c i d c j h
dbihgi	 d b i h g i
adifh	 a d i f h
gi	 g i
cfeja	 c f e j a
chj	 c h j
jj	 j j
bi	 b i
cdbgffag	 c d b g f f a g
ajfdeb	 a j f d e b
ejed	 e j e d
bh	 b h
ih	 i h
jicd	 j i c d
hdecfd	 h d e c f d
ifjdai	 i f j d a i
fj	 f j
hbfbic	 h b f b i c
bdedj	 b d e d j
effchja	 e f f c h j a
ehdejbaae	 e h d e j b a a e
dfe	 d f e
jdafcje	 j d a f c j e
ea	 e a
igabgdhc	 i g a b g d h c
djggfb	 d j g g f b
bafcjdcaj	 b a f c j d c a j
jihffhei	 j i h f f h e i
ifi	 i f i
abfi	 a b f i
cgajbcai	 c g a j b c a i
ceeg	 c e e g
ibihb	 i b i h b
iajj	 i a j j
ai	 a i
hd	 h d
diedijej	 d i e d i j e j
ffedfhd	 f f e d f h d
jjai	 j j a i
aacbafi	 a a c b a f i
didja	 d i d j a
afd	 a f d
dedjf	 d e d j f
jhciibd	 j h c i i b d
eegdhf	 e e g d h f
ga	 g a
cgdgfceg	 c g d g f c e g
ihibiie	 i h i b i i e
heggjjfg	 h e g g j j f g
fciaejf	 f c i a e j f
di	 d i
hfc	 h f c
ebfffd	 e b f f f d
ahebfdddi	 a h e b f d d d i
ahfegfb	 a h f e g f b
hbaeadih	 h b a e a d i h
bc	 b c
fga	 f g a
bfh	 b f h
ee	 e e
gfjfegfc	 g f j f e g f c
bjae	 b j a e
haffabb	 h a f f a b b
jhdfadbf	 j h d f a d b f
jffheecbd	 j f f h e e c b d
ihfaef	 i h f a e f
jdgdhigj	 j d g d h i g j
jdeacbj	 j d e a c b j
dcjhahb	 d c j h a h b
iajcafba	 i a j c a f b a
ibbhgejde	 i b b h g e j d e
gcbfehhcc	 g c b f e h h c c
jjf	 j j f
dgaic	 d g a i c
jeiedejgi	 j e i e d e j g i
fd	 f d
aj	 a j
cifcheb	 c i f c h e b
cddhcc	 c d d h c c
fdfgaec	 f d f g a e c
ciefje	 c i e f j e
egad	 e g a d
ch	 c h
jgjdb	 j g j d b
dijc	 d i j c
eicb	 e i c b
jjhbhcdj	 j j h b h c d j
ehebig	 e h e b i g
baf	 b a f
egb	 e g b
cb	 c b
baeei	 b a e e i
bacibj	 b a c i b j
hdhhabgac	 h d h h a b g a c
hafabhe	 h a f a b h e
fecjbjfi	 f e c j b j f i
gdbh	 g d b h
cdgeabdi	 c d g e a b d i
chijc	 c h i j c
ghgeddhb	 g h g e d d h b
eghegg	 e g h e g g
ef	 e f
hchdaecj	 h c h d a e c j
ghi	 g h i
hfigddja	 h f i g d d j a
aiabiaif	 a i a b i a i f
dfedjabhh	 d f e d j a b h h
ciej	 c i e j
eaifai	 e a i f a i
fiefhdh	 f i e f h d h
efibe	 e f i b e
jdjbbe	 j d j b b e
cdjjbegdc	 c d j j b e g d c
hah	 h a h
afbfeb	 a f b f e b
hhifighhd	 h h i f i g h h d
jagjeeh	 j a g j e e h
iibb	 i i b b
abbddic	 a b b d d i c
id	 i d
hcfeeeh	 h c f e e e h
cb	 c b
bddafb	 b d d a f b
hdjdbe	 h d j d b e
jjaababc	 j j a a b a b c
iiace	 i i a c e
ge	 g e
bciji	 b c i j i
fadhidh	 f a d h i d h
ae	 a e
aea	 a e a
addjcgah	 a d d j c g a h
gjhdbigcd	 g j h d b i g c d
ff	 f f
bfjajbef	 b f j a j b e f
hjcjbgca	 h j c j b g c a
dejbjca	 d e j b j c a
cbgibei	 c b g i b e i
bdd	 b d d
ecjj	 e c j j
dhebdgg	 d h e b d g g
aghhajbij	 a g h h a j b i j
jcifecbaa	 j c i f e c b a a
ibghddiah	 i b g h d d i a h
geeibicf	 g e e i b i c f
gi	 g i
ijjdgihe	 i j j d g i h e
fhdage	 f h d a g e
dhiei	 d h i e i
hfcb	 h f c b
dhd	 d h d
fejcfbd	 f e j c f b d
cfbg	 c f b g
jd	 j d
id	 i d
ec	 e c
hbfcbc	 h b f c b c
cghbid	 c g h b i d
ajjeiabff	 a j j e i a b f f
ijechecae	 i j e c h e c a e
efhb	 e f h b
hhcgbaj	 h h c g b a j
fiii	 f i i i
ifeeehicd	 i f e e e h i c d
haffjj	 h a f f j j
aiigf	 a i i g f
hbgce	 h b g c e
ceefh	 c e e f h
ffhiahje	 f f h i a h j e
jdadd	 j d a d d
eifjjhhf	 e i f j j h h f
aaf	 a a f
edejjgg	 e d e j j g g
gfic	 g f i c
dedjiid	 d e d j i i d
haideb	 h a i d e b
bf	 b f
jgfbef	 j g f b e f
dgdg	 d g d g
ecejijci	 e c e j i j c i
cg	 c g
difj	 d i f j
jcdcecd	 j c d c e c d
cbcjb	 c b c j b
fddifcgi	 f d d i f c g i
dhfaaib	 d h f a a i b
hbggbcgi	 h b g g b c g i
gb	 g b
faaecae	 f a a e c a e
ibdiaie	 i b d i a i e
fe	 f e
aedaed	 a e d a e d
bhbhf	 b h b h f
ajfcia	 a j f c i a
cbfgh	 c b f g h
ffebcijg	 f f e b c i j g
egh	 e g h
dgi	 d g i
bgigcfj	 b g i g c f j
ffeejdacb	 f f e e j d a c b
bi	 b i
abgbbhc	 a b g b b h c
fgd	 f g d
dhbij	 d h b i j
fj	 f j
jjbdag	 j j b d a g
gcdb	 g c d b
hdfhij	 h d f h i j
ggcfeagij	 g g c f e a g i j
dfjbjihja	 d f j b j i h j a
ibefdggia	 i b e f d g g i a
dhbfjgehg	 d h b f j g e h g
cec	 c e c
hafib	 h a f i b
acg	 a c g
ie	 i e
igijibc	 i g i j i b c
hfeb	 h f e b
iag	 i a g
hfffgjhie	 h f f f g j h i e
iieb	 i i e b
bh	 b h
fefbjfg	 f e f b j f g
ejdfjej	 e j d f j e j
ffjab	 f f j a b
beadicha	 b e a d i c h a
aha	 a h a
ca	 c a
fc	 f c
jcd	 j c d
bfcaefag	 b f c a e f a g
jcidfhccj	 j c i d f h c c j
eacg	 e a c g
ibgh	 i b g h
bdfhhc	 b d f h h c
ce	 c e
ibfaec	 i b f a e c
djcgjba	 d j c g j b a
hcf	 h c f
jdbhbc	 j d b h b c
fafh	 f a f h
fbeffjg	 f b e f f j g
jcfcee	 j c f c e e
abdbdgfh	 a b d b d g f h
fcegjhg	 f c e g j h g
hbabgfdd	 h b a b g f d d
jfjjgjd	 j f j j g j d
hhjcddie	 h h j c d d i e
djaheebch	 d j a h e e b c h
cbccjb	 c b c c j b
gbicdae	 g b i c d a e
beda	 b e d a
aajd	 a a j d
ggcjb	 g g c j b
egj	 e g j
fafgg	 f a f g g
igafbci	 i g a f b c i
gehgb	 g e h g b
egb	 e g b
adch	 a d c h
hjfeaagi	 h j f e a a g i
ibiegf	 i b i e g f
aia	 a i a
egeafffhb	 e g e a f f f h b
ge	 g e
jcaebdei	 j c a e b d e i
hg	 h g
dedfgfd	 d e d f g f d
hcig	 h c i g
cgadg	 c g a d g
chhfhhgfb	 c h h f h h g f b
fdeddhgc	 f d e d d h g c
afghceibh	 a f g h c e i b h
icjejhfhh	 i c j e j h f h h
deegefe	 d e e g e f e
eia	 e i a
cjgfd	 c j g f d
eggidchaf	 e g g i d c h a f
dac	 d a c
fbaa	 f b a a
acf	 a c f
dijabdc	 d i j a b d c
eijjfbf	 e i j j f b f
ibdc	 i b d c
ead	 e a d
bacg	 b a c g
he	 h e
bb	 b b
cbaej	 c b a e j
dbia	 d b i a
ehedcjdag	 e h e d c j d a g
dfgcadf	 d f g c a d f
bf	 b f
hfjhbecf	 h f j h b e c f
ic	 i c
acfehbd	 a c f e h b d
dgeiifgb	 d g e i i f g b
gciiff	 g c i i f f
afccfcgi	 a f c c f c g i
jdcfgh	 j d c f g h
fchddfe	 f c h d d f e
gdbejihfg	 g d b e j i h f g
aa	 a a
jcgggjcjj	 j c g g g j c j j
fjjdh	 f j j d h
gf	 g f
ec	 e c
ij	 i j
cf	 c f
dhje	 d h j e
eghfb	 e g h f b
ecgehccah	 e c g e h c c a h
dgacciiee	 d g a c c i i e e
cggd	 c g g d
hg	 h g
ebjcbg	 e b j c b g
bcec	 b c e c
egbib	 e g b i b
ciejbjbi	 c i e j b j b i
hjhjidid	 h j h j i d i d
eejhdgi	 e e j h d g i
chcjjgac	 c h c j j g a c
jgig	 j g i g
bcgeefa	 b c g e e f a
ha	 h a
cbjfjhh	 c b j f j h h
fh	 f h
hcd	 h c d
feibe	 f e i b e
bcfdbaed	 b c f d b a e d
ceacjc	 c e a c j c
dib	 d i b
bhejcafce	 b h e j c a f c e
bddi	 b d d i
bjjidab	 b j j i d a b
igech	 i g e c h
daeagc	 d a e a g c
badcjhfic	 b a d c j h f i c
iagafh	 i a g a f h
bciaj	 b c i a j
ebhdbe	 e b h d b e
egiahaci	 e g i a h a c i
ijeagdged	 i j e a g d g e d
ifcjgabhj	 i f c j g a b h j
fadaggg	 f a d a g g g
dfbj	 d f b j
bici	 b i c i
acecg	 a c e c g
afa	 a f a
jagaffhig	 j a g a f f h i g
hebgbj	 h e b g b j
ahfc	 a h f c
hdebdgec	 h d e b d g e c
eagbg	 e a g b g
dej	 d e j
ga	 g a
igijgfifc	 i g i j g f i f c
jgcicc	 j g c i c c
jihbhaibc	 j i h b h a i b c
iej	 i e j
ibccdgdjb	 i b c c d g d j b
babcchg	 b a b c c h g
bhc	 b h c
ijf	 i j f
hidjah	 h i d j a h
agaii	 a g a i i
eifafjhhf	 e i f a f j h h f
hhjjedfhj	 h h j j e d f h j
ed	 e d
bf	 b f
bhdfea	 b h d f e a
dhef	 d h e f
febcbajib	 f e b c b a j i b
ejeib	 e j e i b
gebfe	 g e b f e
di	 d i
dh	 d h
fabej	 f a b e j
caiafchec	 c a i a f c h e c
je	 j e
egi	 e g i
eacgjea	 e a c g j e a
cgcdch	 c g c d c h
fffhbcbdf	 f f f h b c b d f
ciccii	 c i c c i i
hejehdh	 h e j e h d h
jaad	 j a a d
ha	 h a
agji	 a g j i
bheja	 b h e j a
gf	 g f
hibgjeei	 h i b g j e e i
gbebfafeb	 g b e b f a f e b
bd	 b d
gbfeeb	 g b f e e b
dibbgfgdi	 d i b b g f g d i
djhac	 d j h a c
jbe	 j b e
eiiaccc	 e i i a c c c
gj	 g j
eafegg	 e a f e g g
gchb	 g c h b
fa	 f a
ijg	 i j g
iighbchhi	 i i g h b c h h i
jcceajc	 j c c e a j c
ghahfahdf	 g h a h f a h d f
dafgj	 d a f g j
da	 d a
efeghgicc	 e f e g h g i c c
igb	 i g b
adbccaii	 a d b c c a i i
jcfhgeaj	 j c f h g e a j
djhfee	 d j h f e e
fajh	 f a j h
hfb	 h f b
cgjih	 c g j i h
gggebgjg	 g g g e b g j g
iiggb	 i i g g b
cbi	 c b i
jd	 j d
gdfdcdh	 g d f d c d h
fecbc	 f e c b c
cdjjjdjd	 c d j j j d j d
abchc	 a b c h c
gfeagddbd	 g f e a g d d b d
aachhjgac	 a a c h h j g a c
ccji	 c c j i
dagcgfggd	 d a g c g f g g d
deagdgjhi	 d e a g d g j h i
bhabf	 b h a b f
jgcdd	 j g c d d
gfjbd	 g f j b d
ahjicgee	 a h j i c g e e
aiihg	 a i i h g
aahcji	 a a h c j i
giahjfhe	 g i a h j f h e
eaffaca	 e a f f a c a
cfgbcd	 c f g b c d
fhgfjiad	 f h g f j i a d
id	 i d
bfjjeaba	 b f j j e a b a
fcc	 f c c
ijefaega	 i j e f a e g a
gdj	 g d j
hg	 h g
abg	 a b g
dgde	 d g d e
igbbhhcbb	 i g b b h h c b b
dhiggbc	 d h i g g b c
bebgjbd	 b e b g j b d
edbbb	 e d b b b
gdhaig	 g d h a i g
gbbdhece	 g b b d h e c e
ah	 a h
be	 b e
adj	 a d j
aehia	 a e h i a
cchdfccce	 c c h d f c c c e
eeagi	 e e a g i
hebicdgi	 h e b i c d g i
caedfdjg	 c a e d f d j g
iih	 i i h
bj	 b j
chgdfgh	 c h g d f g h
bhjhcbagd	 b h j h c b a g d
hedhfhaei	 h e d h f h a e i
debgi	 d e b g i
gehfaaiji	 g e h f a a i j i
cadfid	 c a d f i d
ibha	 i b h a
ihhd	 i h h d
cjfgiaj	 c j f g i a j
ahjhgee	 a h j h g e e
hjhbbh	 h j h b b h
da	 d a
ejefdjhgf	 e j e f d j h g f
ejfigjgi	 e j f i g j g i
fchhecfgj	 f c h h e c f g j
aifje	 a i f j e
hgbabia	 h g b a b i a
cdbad	 c d b a d
gieghbjfi	 g i e g h b j f i
bh	 b h
ghid	 g h i d
chcebji	 c h c e b j i
fajddejja	 f a j d d e j j a
jhhcgj	 j h h c g j
gggjfg	 g g g j f g
gfecbbh	 g f e c b b h
hcgcceghb	 h c g c c e g h b
ea	 e a
adiacgiga	 a d i a c g i g a
bgg	 b g g
hd	 h d
afggcic	 a f g g c i c
dfhbfehg	 d f h b f e h g
feffha	 f e f f h a
aahiccfh	 a a h i c c f h
eaeji	 e a e j i
ibicjeef	 i b i c j e e f
dhcib	 d h c i b
gfiab	 g f i a b
fddgd	 f d d g d
cieefhig	 c i e e f h i g
fhd	 f h d
ja	 j a
dfjbcdag	 d f j b c d a g
cfejf	 c f e j f
cadfjedeh	 c a d f j e d e h
aaidfbjhb	 a a i d f b j h b
ajdggi	 a j d g g i
diijjbcdf	 d i i j j b c d f
jfg	 j f g
dcdge	 d c d g e
ejd	 e j d
jccchach	 j c c c h a c h
ihfjjcj	 i h f j j c j
hec	 h e c
jfajfj	 j f a j f j
jifhiaj	 j i f h i a j
icdb	 i c d b
fhic	 f h i c
jcfj	 j c f j
fjijf	 f j i j f
cbhgebcd	 c b h g e b c d
ghj	 g h j
ceiffa	 c e i f f a
cefh	 c e f h
cidg	 c i d g
edbdijajc	 e d b d i j a j c
abcghghbj	 a b c g h g h b j
deahib	 d e a h i b
fiacihgd	 f i a c i h g d
baeedcj	 b a e e d c j
adbchc	 a d b c h c
dehgehdej	 d e h g e h d e j
bh	 b h
fiihai	 f i i h a i
aagfg	 a a g f g
hiddg	 h i d d g
agcejcgg	 a g c e j c g g
hfdjabcdf	 h f d j a b c d f
iff	 i f f
hdbihidji	 h d b i h i d j i
eecbhj	 e e c b h j
hhaij	 h h a i j
bjhgd	 b j h g d
ebbihiag	 e b b i h i a g
jfhdfhfi	 j f h d f h f i
aj	 a j
iij	 i i j
ifgaad	 i f g a a d
babbceg	 b a b b c e g
ejgd	 e j g d
dbedjj	 d b e d j j
fghdh	 f g h d h
edh	 e d h
bfbfjahj	 b f b f j a h j
ffeacc	 f f e a c c
fjie	 f j i e
aiecif	 a i e c i f
fafejdbbg	 f a f e j d b b g
ejccfh	 e j c c f h
cbgdcaag	 c b g d c a a g
fjihcjjc	 f j i h c j j c
ia	 i a
cgjjedfa	 c g j j e d f a
fagfe	 f a g f e
bhieb	 b h i e b
jgga	 j g g a
ecbeafhi	 e c b e a f h i
ahbecf	 a h b e c f
iheg	 i h e g
jgciddgjg	 j g c i d d g j g
jccgb	 j c c g b
ej	 e j
ejgcjjj	 e j g c j j j
cafaf	 c a f a f
bhbbhajh	 b h b b h a j h
adibcffia	 a d i b c f f i a
dfc	 d f c
gb	 g b
acghddaf	 a c g h d d a f
dffgj	 d f f g j
dejbbjcgh	 d e j b b j c g h
jd	 j d
bbfc	 b b f c
aa	 a a
fdfee	 f d f e e
hegfahe	 h e g f a h e
ajigi	 a j i g i
hgcabafij	 h g c a b a f i j
egbcjcj	 e g b c j c j
baf	 b a f
aidecbcc	 a i d e c b c c
djeijh	 d j e i j h
icec	 i c e c
gaeda	 g a e d a
cgcjd	 c g c j d
jhajc	 j h a j c
gj	 g j
fjfj	 f j f j
fjbej	 f j b e j
fhfjc	 f h f j c
bdhgjg	 b d h g j g
jefaad	 j e f a a d
hebcgffc	 h e b c g f f c
jfdba	 j f d b a
hcff	 h c f f
jd	 j d
bbcjeeai	 b b c j e e a i
ei	 e i
ha	 h a
hajiaaii	 h a j i a a i i
bgh	 b g h
ghd	 g h d
dga	 d g a
jcedaaidj	 j c e d a a i d j
aibaehb	 a i b a e h b
ciddj	 c i d d j
eec	 e e c
begecae	 b e g e c a e
cgcf	 c g c f
hehhb	 h e h h b
gb	 g b
jedeibjf	 j e d e i b j f
hggc	 h g g c
dfbjjbg	 d f b j j b g
ei	 e i
hcijiai	 h c i j i a i
bahafja	 b a h a f j a
bha	 b h a
gicja	 g i c j a
iaaejfee	 i a a e j f e e
affhciccb	 a f f h c i c c b
dacdb	 d a c d b
gccj	 g c c j
jbgiajdgd	 j b g i a j d g d
jdaidcegd	 j d a i d c e g d
acb	 a c b
ii	 i i
jf	 j f
hbjcgghj	 h b j c g g h j
ijhbiada	 i j h b i a d a
fbfichj	 f b f i c h j
bidge	 b i d g e
acab	 a c a b
fjigbgai	 f j i g b g a i
ffdideb	 f f d i d e b
cfjedd	 c f j e d d
daee	 d a e e
jhahdiee	 j h a h d i e e
dh	 d h
eigij	 e i g i j
icdjaac	 i c d j a a c
gffg	 g f f g
ia	 i a
gfehc	 g f e h c
dccgj	 d c c g j
ca	 c a
cf	 c f
adihci	 a d i h c i
ceiagacdb	 c e i a g a c d b
jddaegbi	 j d d a e g b i
heefjdh	 h e e f j d h
iebaiehij	 i e b a i e h i j
de	 d e
ga	 g a
gh	 g h
cgbdga	 c g b d g a
hijjej	 h i j j e j
afadi	 a f a d i
bdhegfce	 b d h e g f c e
fih	 f i h
ahjh	 a h j h
feibbf	 f e i b b f
didej	 d i d e j
bh	 b h
hehab	 h e h a b
chdf	 c h d f
ei	 e i
df	 d f
aceid	 a c e i d
gag	 g a g
ade	 a d e
cagbgegg	 c a g b g e g g
ffcagi	 f f c a g i
cdhdhf	 c d h d h f
jcidfgjja	 j c i d f g j j a
eb	 e b
de	 d e
efebagh	 e f e b a g h
ddje	 d d j e
cchefcjjb	 c c h e f c j j b
aejdcjde	 a e j d c j d e
dbjhaa	 d b j h a a
bfajiba	 b f a j i b a
ciihdjjcg	 c i i h d j j c g
fdbdff	 f d b d f f
gbjfafcg	 g b j f a f c g
hij	 h i j
ehcfhacbb	 e h c f h a c b b
bjhdaia	 b j h d a i a
ahiejhhh	 a h i e j h h h
hjgjaj	 h j g j a j
ahddjcf	 a h d d j c f
iic	 i i c
agjjebjc	 a g j j e b j c
gbfdda	 g b f d d a
ahb	 a h b
efbha	 e f b h a
bge	 b g e
ici	 i c i
eccbdigf	 e c c b d i g f
iecj	 i e c j
beiichjd	 b e i i c h j d
bji	 b j i
jjidhjdbj	 j j i d h j d b j
hbbcfheg	 h b b c f h e g
fbehf	 f b e h f
dgi	 d g i
bbi	 b b i
bhachhdd	 b h a c h h d d
cjdeid	 c j d e i d
jejcfgafj	 j e j c f g a f j
dadgfjj	 d a d g f j j
fd	 f d
jc	 j c
ijba	 i j b a
dgeifbda	 d g e i f b d a
gig	 g i g
df	 d f
bdc	 b d c
ja	 j a
afbj	 a f b j
efdjjgb	 e f d j j g b
fjffhjijd	 f j f f h j i j d
bj	 b j
edab	 e d a b
jf	 j f
gegcbc	 g e g c b c
fbie	 f b i e
igdfaafha	 i g d f a a f h a
aiie	 a i i e
ccbece	 c c b e c e
ahe	 a h e
iacfbfcb	 i a c f b f c b
fjhjih	 f j h j i h
dadigf	 d a d i g f
ib	 i b
eadcfefb	 e a d c f e f b
gcfijb	 g c f i j b
bagaacd	 b a g a a c d
bdhf	 b d h f
fcgfa	 f c g f a
figaif	 f i g a i f
fhbid	 f h b i d
fe	 f e
diidfij	 d i i d f i j
db	 d b
aajgeghc	 a a j g e g h c
cafghdh	 c a f g h d h
baaheh	 b a a h e h
idddbfdfc	 i d d d b f d f c
ccchbhj	 c c c h b h j
bfccjgeeh	 b f c c j g e e h
cjf	 c j f
fcejaab	 f c e j a a b
edhecccca	 e d h e c c c c a
faja	 f a j a
fbe	 f b e
bjhdaf	 b j h d a f
ihhijbc	 i h h i j b c
cjc	 c j c
chahibfj	 c h a h i b f j
hhfdd	 h h f d d
ighfee	 i g h f e e
ei	 e i
jgeab	 j g e a b
fdbjachd	 f d b j a c h d
chid	 c h i d
bhdde	 b h d d e
gece	 g e c e
bdf	 b d f
gibabdbef	 g i b a b d b e f
fhdcjieca	 f h d c j i e c a
hhadajb	 h h a d a j b
fbgdgfbe	 f b g d g f b e
jbgjdh	 j b g j d h
debaicaea	 d e b a i c a e a
eihdggg	 e i h d g g g
fadaf	 f a d a f
ab	 a b
bdi	 b d i
aih	 a i h
addhbegi	 a d d h b e g i
acifch	 a c i f c h
agcjaab	 a g c j a a b
fh	 f h
igcg	 i g c g
df	 d f
aaacehfcf	 a a a c e h f c f
ehdbhhhgf	 e h d b h h h g f
bai	 b a i
jfacdjb	 j f a c d j b
bjfcedb	 b j f c e d b
ebgjg	 e b g j g
fbgddag	 f b g d d a g
bjgaadfd	 b j g a a d f d
faehggbi	 f a e h g g b i
gheicdgh	 g h e i c d g h
cedabgh	 c e d a b g h
heddhjbhj	 h e d d h j b h j
jebegca	 j e b e g c a
deg	 d e g
ijfiih	 i j f i i h
eai	 e a i
dhbiegaje	 d h b i e g a j e
ebb	 e b b
deafjbaba	 d e a f j b a b a
dhdgjjdaj	 d h d g j j d a j
bgadgai	 b g a d g a i
fibg	 f i b g
gedbffjd	 g e d b f f j d
jf	 j f
eagj	 e a g j
hchafah	 h c h a f a h
ij	 i j
hgbfgjid	 h g b f g j i d
bcda	 b c d a
bfhci	 b f h c i
gfbhc	 g f b h c
cbbdecbjj	 c b b d e c b j j
cgbeiddha	 c g b e i d d h a
daj	 d a j
edgjhejie	 e d g j h e j i e
ffbgcjdj	 f f b g c j d j
cbhjc	 c b h j c
bijjb	 b i j j b
hej	 h e j
fcbehja	 f c b e h j a
afbhfedcc	 a f b h f e d c c
jb	 j b
idac	 i d a c
digbac	 d i g b a c
adcg	 a d c g
jafjcd	 j a f j c d
hajii	 h a j i i
dgh	 d g h
dgheefgi	 d g h e e f g i
jfffcg	 j f f f c g
dhf	 d h f
echg	 e c h g
ceice	 c e i c e
aceffgic	 a c e f f g i c
fbaajgd	 f b a a j g d
dhef	 d h e f
edccdfije	 e d c c d f i j e
gdd	 g d d
bbaihaj	 b b a i h a j
jjajgcf	 j j a j g c f
hbibcj	 h b i b c j
cafeabg	 c a f e a b g
fijhhhia	 f i j h h h i a
jdh	 j d h
ffci	 f f c i
fgaadbdih	 f g a a d b d i h
hjfifhjae	 h j f i f h j a e
fadac	 f a d a c
gegb	 g e g b
edffbfd	 e d f f b f d
jgbd	 j g b d
cfb	 c f b
gbihadid	 g b i h a d i d
giha	 g i h a
hfdeddd	 h f d e d d d
jiie	 j i i e
geagebadg	 g e a g e b a d g
bbaga	 b b a g a
gfbgf	 g f b g f
iagaddb	 i a g a d d b
bhjh	 b h j h
jfhe	 j f h e
addbdc	 a d d b d c
cgeed	 c g e e d
fdeh	 f d e h
id	 i d
gdaeeebaa	 g d a e e e b a a
bdhdhef	 b d h d h e f
hieggjfga	 h i e g g j f g a
ih	 i h
idbh	 i d b h
djciddbjd	 d j c i d d b j d
bch	 b c h
ijdjfe	 i j d j f e
fbea	 f b e a
dhced	 d h c e d
hfgccigdf	 h f g c c i g d f
jc	 j c
ahiecd	 a h i e c d
ebcbgafjj	 e b c b g a f j j
hdd	 h d d
gagffeeg	 g a g f f e e g
ea	 e a
diajdjcgb	 d i a j d j c g b
iagcdghfb	 i a g c d g h f b
cadjg	 c a d j g
gbjhaffd	 g b j h a f f d
heg	 h e g
bgceif	 b g c e i f
gda	 g d a
ca	 c a
bdc	 b d c
hfcifci	 h f c i f c i
ia	 i a
iecgbdcb	 i e c g b d c b
djejjcjc	 d j e j j c j c
dfe	 d f e
fbdd	 f b d d
ehffb	 e h f f b
gad	 g a d
ehfidij	 e h f i d i j
abbbhhd	 a b b b h h d
dciijefe	 d c i i j e f e
djb	 d j b
jibgfjjg	 j i b g f j j g
fiieb	 f i i e b
ajfaifee	 a j f a i f e e
fcaj	 f c a j
cbagjia	 c b a g j i a
eba	 e b a
hbdbiijdh	 h b d b i i j d h
aiid	 a i i d
fhfi	 f h f i
ace	 a c e
ihe	 i h e
igig	 i g i g
cij	 c i j
fcggjje	 f c g g j j e
ijddihghb	 i j d d i h g h b
fie	 f i e
gecdgidcb	 g e c d g i d c b
gefhfgh	 g e f h f g h
dcgdbahcb	 d c g d b a h c b
eebgcdegc	 e e b g c d e g c
agbffeaf	 a g b f f e a f
hagcbgah	 h a g c b g a h
dg	 d g
eeeiica	 e e e i i c a
feb	 f e b
fggfjcg	 f g g f j c g
jede	 j e d e
ciiggdfci	 c i i g g d f c i
eeg	 e e g
aeaj	 a e a j
iif	 i i f
gjij	 g j i j
cd	 c d
jifddh	 j i f d d h
gj	 g j
geh	 g e h
deaijcj	 d e a i j c j
agicbc	 a g i c b c
caic	 c a i c
bdaj	 b d a j
igbihba	 i g b i h b a
bcgih	 b c g i h
bigfe	 b i g f e
ajiagaad	 a j i a g a a d
jjeee	 j j e e e
egdadj	 e g d a d j
acdbcgjg	 a c d b c g j g
igjfdd	 i g j f d d
jeccgahh	 j e c c g a h h
ifhe	 i f h e
igcaci	 i g c a c i
dhddc	 d h d d c
ja	 j a
dbhifai	 d b h i f a i
cg	 c g
iah	 i a h
ed	 e d
dedcjhc	 d e d c j h c
bbaaheb	 b b a a h e b
gjecdaia	 g j e c d a i a
ce	 c e
ci	 c i
dfcajbebd	 d f c a j b e b d
iad	 i a d
heij	 h e i j
eifbe	 e i f b e
ijb	 i j b
fbcc	 f b c c
ihbh	 i h b h
ce	 c e
diddb	 d i d d b
edfib	 e d f i b
jcaccfi	 j c a c c f i
hhha	 h h h a
gcbh	 g c b h
geebbc	 g e e b b c
jcifh	 j c i f h
diaghihhc	 d i a g h i h h c
dcbijbfea	 d c b i j b f e a
jihdcbgid	 j i h d c b g i d
egag	 e g a g
af	 a f
cfjb	 c f j b
fbh	 f b h
ccdecjbcc	 c c d e c j b c c
fhjjedc	 f h j j e d c
bjefgj	 b j e f g j
hih	 h i h
adjceeb	 a d j c e e b
gjiaghch	 g j i a g h c h
cefd	 c e f d
jichhc	 j i c h h c
ad	 a d
cfigb	 c f i g b
ij	 i j
cfgic	 c f g i c
caadaefhh	 c a a d a e f h h
cciibfbb	 c c i i b f b b
bicg	 b i c g
ghf	 g h f
igadhcdh	 i g a d h c d h
ihbjd	 i h b j d
decd	 d e c d
iihcdgjb	 i i h c d g j b
hdeajaeai	 h d e a j a e a i
ighaga	 i g h a g a
fgj	 f g j
gijac	 g i j a c
ijgg	 i j g g
ejgbgc	 e j g b g c
ghehbjef	 g h e h b j e f
ceffbj	 c e f f b j
bhecig	 b h e c i g
accghe	 a c c g h e
idjgji	 i d j g j i
ci	 c i
dgbhicci	 d g b h i c c i
cbgdbffe	 c b g d b f f e
cc	 c c
bfhc	 b f h c
dbia	 d b i a
jfdahihbi	 j f d a h i h b i
gibef	 g i b e f
adhgcf	 a d h g c f
ghfcjgddi	 g h f c j g d d i
checfbii	 c h e c f b i i
ghdijafcj	 g h d i j a f c j
diab	 d i a b
ifhcaac	 i f h c a a c
ediid	 e d i i d
jeiic	 j e i i c
cjghbd	 c j g h b d
gg	 g g
dihaib	 d i h a i b
idhb	 i d h b
efddcgc	 e f d d c g c
cai	 c a i
hgbdfc	 h g b d f c
figbh	 f i g b h
hejaef	 h e j a e f
hdfi	 h d f i
aiic	 a i i c
dcgcjed	 d c g c j e d
cjdahcfi	 c j d a h c f i
ficbahdcf	 f i c b a h d c f
bchf	 b c h f
fff	 f f f
bdf	 b d f
jgiahcb	 j g i a h c b
jigef	 j i g e f
fbadgha	 f b a d g h a
fgfdfac	 f g f d f a c
dhgfa	 d h g f a
eciiab	 e c i i a b
jcgh	 j c g h
ije	 i j e
bihdj	 b i h d j
fjjbeejei	 f j j b e e j e i
bcfhdaeai	 b c f h d a e a i
hb	 h b
cijhid	 c i j h i d
jfg	 j f g
eec	 e e c
jijgcfffg	 j i j g c f f f g
aebdecjd	 a e b d e c j d
faahhb	 f a a h h b
dafe	 d a f e
cibje	 c i b j e
hhehfdj	 h h e h f d j
ehid	 e h i d
badbd	 b a d b d
ihcjeha	 i h c j e h a
jcgaea	 j c g a e a
iadfjjgj	 i a d f j j g j
dgggeeedd	 d g g g e e e d d
ihjdgif	 i h j d g i f
gb	 g b
abaebe	 a b a e b e
dj	 d j
dgaad	 d g a a d
gejdg	 g e j d g
hdd	 h d d
fcf	 f c f
aefchd	 a e f c h d
ggi	 g g i
eeaahjh	 e e a a h j h
jghjfaihj	 j g h j f a i h j
cedcja	 c e d c j a
edgdd	 e d g d d
cdfjeg	 c d f j e g
eagg	 e a g g
cidgfbj	 c i d g f b j
cjbcid	 c j b c i d
jhcbe	 j h c b e
bhejegf	 b h e j e g f
ecdhcdbh	 e c d h c d b h
gbib	 g b i b
cdje	 c d j e
cbcb	 c b c b
jgegcfbab	 j g e g c f b a b
ibjc	 i b j c
fad	 f a d
bbhjgcgd	 b b h j g c g d
gj	 g j
fhcih	 f h c i h
aefejije	 a e f e j i j e
ccbeb	 c c b e b
hhhfah	 h h h f a h
hi	 h i
efeeicbeg	 e f e e i c b e g
cjdjhdejc	 c j d j h d e j c
cjjfcgc	 c j j f c g c
aaj	 a a j
jcb	 j c b
bjhhcaajb	 b j h h c a a j b
iehbdcgch	 i e h b d c g c h
fei	 f e i
fgcb	 f g c b
jbjjjcbi	 j b j j j c b i
dajcebhij	 d a j c e b h i j
iacceg	 i a c c e g
dgedjjbb	 d g e d j j b b
eefdfed	 e e f d f e d
hcfagaf	 h c f a g a f
fffjjjfc	 f f f j j j f c
ebhcdihj	 e b h c d i h j
dfc	 d f c
ib	 i b
agf	 a g f
jcig	 j c i g
hjfciagcc	 h j f c i a g c c
fdh	 f d h
iacjhedje	 i a c j h e d j e
hh	 h h
aifcefffg	 a i f c e f f f g
hg	 h g
jdf	 j d f
fha	 f h a
hbe	 h b e
eieeehehg	 e i e e e h e h g
ijffbeb	 i j f f b e b
agih	 a g i h
fcbecjhhi	 f c b e c j h h i
ajghab	 a j g h a b
bggaeab	 b g g a e a b
jjeiegf	 j j e i e g f
jgich	 j g i c h
egeh	 e g e h
bed	 b e d
de	 d e
eh	 e h
jg	 j g
jhhjd	 j h h j d
bjhc	 b j h c
gedgaica	 g e d g a i c a
ghgjcihb	 g h g j c i h b
hifeaei	 h i f e a e i
ibdi	 i b d i
fbca	 f b c a
ejeajcbij	 e j e a j c b i j
bghiech	 b g h i e c h
gghchghg	 g g h c h g h g
gaeedcjef	 g a e e d c j e f
iifh	 i i f h
gbfad	 g b f a d
ehhbd	 e h h b d
ahgbbgfii	 a h g b b g f i i
abid	 a b i d
gb	 g b
hca	 h c a
ihheighbg	 i h h e i g h b g
ciiaeijf	 c i i a e i j f
ifgfeiaf	 i f g f e i a f
bjhcfi	 b j h c f i
cacdhiefb	 c a c d h i e f b
hhgjjdjdb	 h h g j j d j d b
deebejbgd	 d e e b e j b g d
fdf	 f d f
cgifhhfea	 c g i f h h f e a
bija	 b i j a
bghieafg	 b g h i e a f g
gcaj	 g c a j
hbhab	 h b h a b
djace	 d j a c e
eiefdhccg	 e i e f d h c c g
edb	 e d b
feecged	 f e e c g e d
iedjdgfeb	 i e d j d g f e b
hah	 h a h
faheejd	 f a h e e j d
beajdcdbe	 b e a j d c d b e
jgfhabjjc	 j g f h a b j j c
giddc	 g i d d c
cjdccebdh	 c j d c c e b d h
haajaie	 h a a j a i e
jaaaehg	 j a a a e h g
ecf	 e c f
fdccbiab	 f d c c b i a b
ahejff	 a h e j f f
fffaifi	 f f f a i f i
afceghj	 a f c e g h j
ciaajj	 c i a a j j
ggie	 g g i e
agfdij	 a g f d i j
dciia	 d c i i a
ecbgbbfb	 e c b g b b f b
agcgfadg	 a g c g f a d g
gebdi	 g e b d i
jjjbc	 j j j b c
bfahcjdd	 b f a h c j d d
bbifhg	 b b i f h g
bgabg	 b g a b g
dedcicagh	 d e d c i c a g h
ihjcbhgd	 i h j c b h g d
eidaiedd	 e i d a i e d d
hhfehcje	 h h f e h c j e
egahgfagb	 e g a h g f a g b
ieibdc	 i e i b d c
biajabf	 b i a j a b f
agcdbhhcg	 a g c d b h h c g
ghicia	 g h i c i a
hebcged	 h e b c g e d
jchggg	 j c h g g g
iiha	 i i h a
iajgdd	 i a j g d d
jgje	 j g j e
fdfh	 f d f h
diccg	 d i c c g
jj	 j j
cbhbfe	 c b h b f e
cdgfgeeea	 c d g f g e e e a
jh	 j h
igbadjefe	 i g b a d j e f e
ag	 a g
cbfii	 c b f i i
bidijegeb	 b i d i j e g e b
jcadj	 j c a d j
bgd	 b g d
ajb	 a j b
dgebfb	 d g e b f b
ib	 i b
ehdc	 e h d c
jeh	 j e h
iiheigiee	 i i h e i g i e e
ggacf	 g g a c f
cg	 c g
jdgdged	 j d g d g e d
befia	 b e f i a
cbhbhh	 c b h b h h
gjiae	 g j i a e
agdcb	 a g d c b
affef	 a f f e f
iibdd	 i i b d d
ccadic	 c c a d i c
fcffh	 f c f f h
ff	 f f
ghgaccjc	 g h g a c c j c
agggdhbhe	 a g g g d h b h e
affgedfgg	 a f f g e d f g g
gacjc	 g a c j c
egdbf	 e g d b f
af	 a f
dhjaeiage	 d h j a e i a g e
aiaaeih	 a i a a e i h
adaj	 a d a j
gb	 g b
dejh	 d e j h
dh	 d h
icbeagagb	 i c b e a g a g b
ddgehj	 d d g e h j
hggcbgab	 h g g c b g a b
cbgihf	 c b g i h f
bejigfadf	 b e j i g f a d f
fbigje	 f b i g j e
behb	 b e h b
gbcbcjig	 g b c b c j i g
cfigbgiji	 c f i g b g i j i
afgfeeh	 a f g f e e h
jaaa	 j a a a
jhjadhfd	 j h j a d h f d
chjhdbjbc	 c h j h d b j b c
gg	 g g
eef	 e e f
agif	 a g i f
gaahbhjd	 g a a h b h j d
fdidead	 f d i d e a d
cjc	 c j c
ddgdefefg	 d d g d e f e f g
bhfdgefcj	 b h f d g e f c j
cc	 c c
ebdecfjj	 e b d e c f j j
caahjbehi	 c a a h j b e h i
afj	 a f j
haeadehd	 h a e a d e h d
ajibd	 a j i b d
haaa	 h a a a
bhabgf	 b h a b g f
ccdigh	 c c d i g h
hbdi	 h b d i
bigjbef	 b i g j b e f
he	 h e
jijdegd	 j i j d e g d
gjddaed	 g j d d a e d
ffdc	 f f d c
dcjhjdj	 d c j h j d j
eaagi	 e a a g i
jhejcjebi	 j h e j c j e b i
bgbic	 b g b i c
ghdbbeb	 g h d b b e b
fcdfcahe	 f c d f c a h e
cahif	 c a h i f
chdcj	 c h d c j
cdfbj	 c d f b j
jgdj	 j g d j
icbhb	 i c b h b
fcehc	 f c e h c
gaicic	 g a i c i c
hdbe	 h d b e
gjjdia	 g j j d i a
fjcffb	 f j c f f b
fddfdihj	 f d d f d i h j
abb	 a b b
cdajg	 c d a j g
ch	 c h
dc	 d c
bcgadc	 b c g a d c
eb	 e b
eijjbjg	 e i j j b j g
fa	 f a
ccbfad	 c c b f a d
ig	 i g
dhhfj	 d h h f j
bib	 b i b
gfccge	 g f c c g e
eac	 e a c
ddebfj	 d d e b f j
ied	 i e d
fffc	 f f f c
debchjdc	 d e b c h j d c
dbi	 d b i
dbfceh	 d b f c e h
fbe	 f b e
gbfdbijej	 g b f d b i j e j
ceaahe	 c e a a h e
gghjgcie	 g g h j g c i e
fh	 f h
hjibcigc	 h j i b c i g c
jgfbbijd	 j g f b b i j d
ddibfcij	 d d i b f c i j
djd	 d j d
gdifgjcef	 g d i f g j c e f
fjh	 f j h
ifia	 i f i a
eacfcb	 e a c f c b
bifdbghh	 b i f d b g h h
dh	 d h
igabi	 i g a b i
cdgicjfg	 c d g i c j f g
debbg	 d e b b g
dgii	 d g i i
gefjfci	 g e f j f c i
fgjiaj	 f g j i a j
ac	 a c
jidef	 j i d e f
dbhdfbd	 d b h d f b d
dcee	 d c e e
hbhbhfii	 h b h b h f i i
hbg	 h b g
bggegeg	 b g g e g e g
fcbahhif	 f c b a h h i f
ijc	 i j c
fe	 f e
bghhgadia	 b g h h g a d i a
ceb	 c e b
fijheahj	 f i j h e a h j
fecfhdcei	 f e c f h d c e i
jjfgcjhj	 j j f g c j h j
dgicd	 d g i c d
jjje	 j j j e
iihhcghb	 i i h h c g h b
fbbcije	 f b b c i j e
iecjedc	 i e c j e d c
bchhf	 b c h h f
ec	 e c
ca	 c a
fjhdgi	 f j h d g i
dafb	 d a f b
dg	 d g
cicdcic	 c i c d c i c
egaibfjh	 e g a i b f j h
gie	 g i e
cdaaedeif	 c d a a e d e i f
bjdjga	 b j d j g a
cid	 c i d
gdg	 g d g
cefige	 c e f i g e
fia	 f i a
ijagbbi	 i j a g b b i
ggfij	 g g f i j
fiechej	 f i e c h e j
idgaahbh	 i d g a a h b h
fjhagbjig	 f j h a g b j i g
ejehfb	 e j e h f b
jee	 j e e
dcfcjdigh	 d c f c j d i g h
hidcgb	 h i d c g b
gbicajfc	 g b i c a j f c
ii	 i i
dhiegff	 d h i e g f f
acafghg	 a c a f g h g
ebif	 e b i f
bdgcbh	 b d g c b h
jhbgef	 j h b g e f
fjece	 f j e c e
iaidf	 i a i d f
hddh	 h d d h
ideaiha	 i d e a i h a
bachadd	 b a c h a d d
iehhec	 i e h h e c
dbe	 d b e
hcgbjjjgc	 h c g b j j j g c
hb	 h b
jig	 j i g
jjhiedjbh	 j j h i e d j b h
bdeji	 b d e j i
cjcjbi	 c j c j b i
fjgfiiieh	 f j g f i i i e h
dbhcjafea	 d b h c j a f e a
bdfbi	 b d f b i
abcj	 a b c j
gi	 g i
haib	 h a i b
hib	 h i b
ccfabddb	 c c f a b d d b
fheejhc	 f h e e j h c
aec	 a e c
hehf	 h e h f
gicidbc	 g i c i d b c
fjah	 f j a h
hfafidajb	 h f a f i d a j b
igihebigh	 i g i h e b i g h
jgbjgidjf	 j g b j g i d j f
hehh	 h e h h
aachc	 a a c h c
edbgbae	 e d b g b a e
bi	 b i
beg	 b e g
ac	 a c
jahdffi	 j a h d f f i
adfej	 a d f e j
hbbcca	 h b b c c a
bbfc	 b b f c
hagb	 h a g b
ae	 a e
egbgddafa	 e g b g d d a f a
beddgbb	 b e d d g b b
jachjh	 j a c h j h
iibd	 i i b d
gdfj	 g d f j
gfbhebafc	 g f b h e b a f c
df	 d f
dgijahbaf	 d g i j a h b a f
bgabjagd	 b g a b j a g d
gjfge	 g j f g e
agcji	 a g c j i
fceihaigj	 f c e i h a i g j
iii	 i i i
beggafdb	 b e g g a f d b
ehagcah	 e h a g c a h
fcedcj	 f c e d c j
jdgh	 j d g h
fgddddf	 f g d d d d f
eifgg	 e i f g g
dja	 d j a
hed	 h e d
ehbehd	 e h b e h d
jbj	 j b j
gccg	 g c c g
ai	 a i
ggaf	 g g a f
cafefcdif	 c a f e f c d i f
aige	 a i g e
hafdhbd	 h a f d h b d
bbgc	 b b g c
ehcdig	 e h c d i g
fjc	 f j c
bjccd	 b j c c d
eeheb	 e e h e b
hgje	 h g j e
fegef	 f e g e f
ediijbaf	 e d i i j b a f
eifbjbee	 e i f b j b e e
aa	 a a
ch	 c h
hidgdfjh	 h i d g d f j h
fb	 f b
eeihhbf	 e e i h h b f
ebg	 e b g
hfbi	 h f b i
ffbibdbii	 f f b i b d b i i
hdi	 h d i
igi	 i g i
hedebijdf	 h e d e b i j d f
higdjgehj	 h i g d j g e h j
hbiajijfg	 h b i a j i j f g
djhg	 d j h g
cbgdf	 c b g d f
bjjh	 b j j h
ccgahgg	 c c g a h g g
ebjifi	 e b j i f i
bichjfc	 b i c h j f c
agjdaffc	 a g j d a f f c
eijcfbed	 e i j c f b e d
hddfgijbg	 h d d f g i j b g
afgfede	 a f g f e d e
afhdga	 a f h d g a
abicggifd	 a b i c g g i f d
bdejcea	 b d e j c e a
bjf	 b j f
idgibb	 i d g i b b
dejifjje	 d e j i f j j e
ejgjjahbh	 e j g j j a h b h
fcfgaia	 f c f g a i a
bjj	 b j j
hgff	 h g f f
ehacbh	 e h a c b h
biaijidgh	 b i a i j i d g h
bfeijci	 b f e i j c i
dfe	 d f e
eididj	 e i d i d j
dbccca	 d b c c c a
aciaid	 a c i a i d
gaececg	 g a e c e c g
hfjg	 h f j g
hfecchj	 h f e c c h j
beh	 b e h
cbbb	 c b b b
aheide	 a h e i d e
bcidab	 b c i d a b
aabfie	 a a b f i e
ebe	 e b e
adagbca	 a d a g b c a
adhg	 a d h g
gghfhcbg	 g g h f h c b g
ajjdaajdf	 a j j d a a j d f
dhdiec	 d h d i e c
ifhgjgbi	 i f h g j g b i
bajafdc	 b a j a f d c
hefifhjh	 h e f i f h j h
hhc	 h h c
accef	 a c c e f
igfdadgcb	 i g f d a d g c b
eecf	 e e c f
bag	 b a g
da	 d a
bijjj	 b i j j j
cddbb	 c d d b b
ffec	 f f e c
eac	 e a c
daejaidd	 d a e j a i d d
bihia	 b i h i a
ej	 e j
fcib	 f c i b
beahiajf	 b e a h i a j f
dijf	 d i j f
cjea	 c j e a
dfhbahhaa	 d f h b a h h a a
fajihdef	 f a j i h d e f
acedehgd	 a c e d e h g d
ifbbch	 i f b b c h
idacj	 i d a c j
adjiiijb	 a d j i i i j b
jjb	 j j b
eg	 e g
hefdejej	 h e f d e j e j
eijgjei	 e i j g j e i
jih	 j i h
daefechj	 d a e f e c h j
ce	 c e
ghgaji	 g h g a j i
jb	 j b
eieedgid	 e i e e d g i d
ibechbi	 i b e c h b i
caigfji	 c a i g f j i
jciihjae	 j c i i h j a e
dfheeeed	 d f h e e e e d
fj	 f j
eide	 e i d e
bbcid	 b b c i d
hjhfb	 h j h f b
geiaeb	 g e i a e b
gbebbeib	 g b e b b e i b
gjfbjgfg	 g j f b j g f g
ejifhh	 e j i f h h
hh	 h h
jhigj	 j h i g j
ccjdb	 c c j d b
ec	 e c
ii	 i i
gjjhdijhb	 g j j h d i j h b
fjegid	 f j e g i d
bjb	 b j b
ecfg	 e c f g
bifieiaag	 b i f i e i a a g
fc	 f c
cbffbib	 c b f f b i b
gg	 g g
fh	 f h
bfd	 b f d
bejjdecfa	 b e j j d e c f a
ideah	 i d e a h
eb	 e b
eegjhfac	 e e g j h f a c
ifgccie	 i f g c c i e
cbbgdii	 c b b g d i i
ghggicf	 g h g g i c f
ccab	 c c a b
dgcaabi	 d g c a a b i
adbh	 a d b h
ag	 a g
jgabfjfie	 j g a b f j f i e
dfcgga	 d f c g g a
jffjabhgc	 j f f j a b h g c
bifccjf	 b i f c c j f
hd	 h d
jbe	 j b e
efai	 e f a i
jbbjaghg	 j b b j a g h g
jjcdac	 j j c d a c
jadh	 j a d h
hgig	 h g i g
jiecccid	 j i e c c c i d
jjhiebf	 j j h i e b f
aeeaja	 a e e a j a
dcbcffbcg	 d c b c f f b c g
jhdeba	 j h d e b a
bdcaa	 b d c a a
chhd	 c h h d
gagce	 g a g c e
bffefh	 b f f e f h
bhedf	 b h e d f
ic	 i c
ecaghhhac	 e c a g h h h a c
hgg	 h g g
ff	 f f
gaajf	 g a a j f
icd	 i c d
gdihbf	 g d i h b f
be	 b e
ffifce	 f f i f c e
cia	 c i a
cb	 c b
deejdgdfd	 d e e j d g d f d
gih	 g i h
dc	 d c
gejdfibi	 g e j d f i b i
jejafac	 j e j a f a c
idjdbccch	 i d j d b c c c h
dhedgj	 d h e d g j
bdgegc	 b d g e g c
eijga	 e i j g a
ggiich	 g g i i c h
cjidee	 c j i d e e
cgg	 c g g
fjdgg	 f j d g g
aai	 a a i
acghfb	 a c g h f b
eji	 e j i
fb	 f b
jh	 j h
cccchh	 c c c c h h
gbb	 g b b
ahbca	 a h b c a
ha	 h a
hfeie	 h f e i e
eb	 e b
bec	 b e c
gbfied	 g b f i e d
ce	 c e
cbhjdhc	 c b h j d h c
dfgdagjd	 d f g d a g j d
dcbji	 d c b j i
fgf	 f g f
dffcje	 d f f c j e
ggiehbbf	 g g i e h b b f
ecd	 e c d
hijgfjf	 h i j g f j f
jaficce	 j a f i c c e
agegchb	 a g e g c h b
faji	 f a j i
djfcbdaeh	 d j f c b d a e h
ced	 c e d
dihhd	 d i h h d
ea	 e a
eahbbdi	 e a h b b d i
iiecaghg	 i i e c a g h g
dic	 d i c
gdde	 g d d e
ccbgbjb	 c c b g b j b
jfbcbic	 j f b c b i c
eb	 e b
ci	 c i
fg	 f g
eibefh	 e i b e f h
hic	 h i c
gfbaddae	 g f b a d d a e
cebe	 c e b e
bi	 b i
edhfa	 e d h f a
ehecc	 e h e c c
cdd	 c d d
gacfbih	 g a c f b i h
idhgedhec	 i d h g e d h e c
bdf	 b d f
chadd	 c h a d d
gdjba	 g d j b a
cijbiif	 c i j b i i f
eagjgg	 e a g j g g
jehehf	 j e h e h f
jachghd	 j a c h g h d
gfebjgb	 g f e b j g b
gcecc	 g c e c c
aajfe	 a a j f e
icibcj	 i c i b c j
cbgiafec	 c b g i a f e c
bgiefa	 b g i e f a
gjcaidi	 g j c a i d i
feciadbe	 f e c i a d b e
jbbfjifj	 j b b f j i f j
ahacc	 a h a c c
fe	 f e
gghihh	 g g h i h h
difhfhhc	 d i f h f h h c
cijhdfe	 c i j h d f e
hgac	 h g a c
cca	 c c a
jcacdifd	 j c a c d i f d
efjggdhfi	 e f j g g d h f i
jbejcdjfh	 j b e j c d j f h
icdcafaj	 i c d c a f a j
fc	 f c
cgja	 c g j a
hchijah	 h c h i j a h
ab	 a b
fb	 f b
hgcebjead	 h g c e b j e a d
hfci	 h f c i
ifhidife	 i f h i d i f e
ifjefe	 i f j e f e
bddecajh	 b d d e c a j h
gibfhe	 g i b f h e
efdjhgbhg	 e f d j h g b h g
eefeeeig	 e e f e e e i g
gggd	 g g g d
ic	 i c
baejdj	 b a e j d j
bhhjhg	 b h h j h g
ciadecgd	 c i a d e c g d
hbif	 h b i f
habghieb	 h a b g h i e b
fcgfcjg	 f c g f c j g
jhfdfgad	 j h f d f g a d
cjd	 c j d
ffgifac	 f f g i f a c
jc	 j c
bf	 b f
geda	 g e d a
chgh	 c h g h
cdae	 c d a e
egffhe	 e g f f h e
ia	 i a
fb	 f b
efcicbcfd	 e f c i c b c f d
gfgjee	 g f g j e e
gffegi	 g f f e g i
eihfigcb	 e i h f i g c b
eficb	 e f i c b
dbfh	 d b f h
bfddicfj	 b f d d i c f j
jbe	 j b e
egjegh	 e g j e g h
jgghbj	 j g g h b j
fifjajbi	 f i f j a j b i
gidhfab	 g i d h f a b
hc	 h c
abehbdjjg	 a b e h b d j j g
bh	 b h
cbiacffd	 c b i a c f f d
eejfjg	 e e j f j g
ijeddg	 i j e d d g
hcgciac	 h c g c i a c
daeie	 d a e i e
cgacfdjjh	 c g a c f d j j h
bbecgfcfi	 b b e c g f c f i
fddi	 f d d i
ifibj	 i f i b j
bhfai	 b h f a i
fiec	 f i e c
gi	 g i
aijd	 a i j d
hjba	 h j b a
ifie	 i f i e
ibiieg	 i b i i e g
fda	 f d a
bf	 b f
ahfaeija	 a h f a e i j a
edcjfdfe	 e d c j f d f e
edi	 e d i
ggih	 g g i h
ifbfaa	 i f b f a a
dea	 d e a
gibd	 g i b d
fcaabcbeb	 f c a a b c b e b
cdjfghjch	 c d j f g h j c h
caafejdbd	 c a a f e j d b d
ggfcbfidf	 g g f c b f i d f
biech	 b i e c h
fighiegha	 f i g h i e g h a
bejcc	 b e j c c
gcaijb	 g c a i j b
fa	 f a
ahbcida	 a h b c i d a
fidjih	 f i d j i h
dgbac	 d g b a c
dbahb	 d b a h b
cfdie	 c f d i e
dejgf	 d e j g f
jih	 j i h
jfi	 j f i
bcfcehgaf	 b c f c e h g a f
bijiihfe	 b i j i i h f e
jjhdid	 j j h d i d
dajbdg	 d a j b d g
je	 j e
eaij	 e a i j
hhhfj	 h h h f j
iicdhbe	 i i c d h b e
abjeic	 a b j e i c
faffcb	 f a f f c b
fabib	 f a b i b
eecgcghie	 e e c g c g h i e
fdahefgef	 f d a h e f g e f
bebiicggj	 b e b i i c g g j
cgdfg	 c g d f g
acdhaie	 a c d h a i e
cichde	 c i c h d e
hadffgbc	 h a d f f g b c
hf	 h f
ef	 e f
ihi	 i h i
gaij	 g a i j
ebfddg	 e b f d d g
djifj	 d j i f j
dcica	 d c i c a
dgjjaidh	 d g j j a i d h
jjghdbagg	 j j g h d b a g g
ie	 i e
jajjjjj	 j a j j j j j
bed	 b e d
idaeih	 i d a e i h
bbaifebg	 b b a i f e b g
bdeadbcg	 b d e a d b c g
acdhighbi	 a c d h i g h b i
hcdd	 h c d d
bhhehfgc	 b h h e h f g c
bic	 b i c
hheggg	 h h e g g g
chfjdiec	 c h f j d i e c
fg	 f g
ehbi	 e h b i
aadfh	 a a d f h
cdhhfb	 c d h h f b
ech	 e c h
cad	 c a d
hbiga	 h b i g a
bgiiefbdg	 b g i i e f b d g
bjb	 b j b
ijhgcbh	 i j h g c b h
fibbfa	 f i b b f a
bffaefi	 b f f a e f i
gffh	 g f f h
eijf	 e i j f
bdegcjb	 b d e g c j b
aijdae	 a i j d a e
iiehc	 i i e h c
bedf	 b e d f
ggjeih	 g g j e i h
bigdijhhg	 b i g d i j h h g
jdbbgij	 j d b b g i j
hbifafiai	 h b i f a f i a i
bebcigi	 b e b c i g i
ab	 a b
bbibej	 b b i b e j
ab	 a b
ag	 a g
cbaijj	 c b a i j j
haaaffjfa	 h a a a f f j f a
fhibfde	 f h i b f d e
dahaebhih	 d a h a e b h i h
ehc	 e h c
jehfdbaeb	 j e h f d b a e b
dadd	 d a d d
fjj	 f j j
cii	 c i i
gbehgf	 g b e h g f
ghfehhdeh	 g h f e h h d e h
icf	 i c f
dbdjei	 d b d j e i
jhi	 j h i
icffdg	 i c f f d g
ehd	 e h d
jed	 j e d
ibjc	 i b j c
hjcj	 h j c j
effjj	 e f f j j
fhb	 f h b
jffghgejd	 j f f g h g e j d
eddedejh	 e d d e d e j h
ceeba	 c e e b a
gdfjdbci	 g d f j d b c i
hiid	 h i i d
hebi	 h e b i
bf	 b f
igcah	 i g c a h
fef	 f e f
jjgjec	 j j g j e c
cfbihddj	 c f b i h d d j
hfbchcbfb	 h f b c h c b f b
bia	 b i a
df	 d f
dcbhfijj	 d c b h f i j j
de	 d e
abbdegi	 a b b d e g i
egagcda	 e g a g c d a
fifiif	 f i f i i f
bbbjbcj	 b b b j b c j
hgihjc	 h g i h j c
bifdjfcb	 b i f d j f c b
eii	 e i i
dhf	 d h f
chcbh	 c h c b h
gbidgb	 g b i d g b
cjgdcefi	 c j g d c e f i
ajjf	 a j j f
cbfif	 c b f i f
djeb	 d j e b
jhjceeci	 j h j c e e c i
jccj	 j c c j
ecbfcda	 e c b f c d a
fjgiacgb	 f j g i a c g b
hjidgf	 h j i d g f
bdj	 b d j
af	 a f
geeh	 g e e h
ffbia	 f f b i a
jdci	 j d c i
hdddf	 h d d d f
bhedefac	 b h e d e f a c
gf	 g f
fjgcejja	 f j g c e j j a
achgh	 a c h g h
gjdcihbef	 g j d c i h b e f
fefgfgcc	 f e f g f g c c
ejide	 e j i d e
ggdjjijf	 g g d j j i j f
bdecae	 b d e c a e
fhc	 f h c
ibcb	 i b c b
feafgieg	 f e a f g i e g
ggff	 g g f f
edhfece	 e d h f e c e
gddfb	 g d d f b
jgcj	 j g c j
bd	 b d
djhae	 d j h a e
db	 d b
bhcfi	 b h c f i
dgbjada	 d g b j a d a
jbc	 j b c
hdfibdc	 h d f i b d c
defaahaa	 d e f a a h a a
ieejh	 i e e j h
dgihcj	 d g i h c j
aaeibdccg	 a a e i b d c c g
djdchbabd	 d j d c h b a b d
fcfdi	 f c f d i
gjjaeg	 g j j a e g
aa	 a a
bh	 b h
dhfcajb	 d h f c a j b
gcje	 g c j e
dgb	 d g b
iabfhgb	 i a b f h g b
ahhaj	 a h h a j
jd	 j d
faacbhe	 f a a c b h e
hjbb	 h j b b
jebjfihfa	 j e b j f i h f a
ihjac	 i h j a c
jaaadbff	 j a a a d b f f
hijef	 h i j e f
egfefh	 e g f e f h
cbgcbba	 c b g c b b a
fdjbj	 f d j b j
ghaaccacb	 g h a a c c a c b
dbfbfjhig	 d b f b f j h i g
iha	 i h a
hjdef	 h j d e f
edaf	 e d a f
aa	 a a
aa	 a a
ha	 h a
fhidfcb	 f h i d f c b
ebac	 e b a c
fidgbeg	 f i d g b e g
bdbdae	 b d b d a e
eejf	 e e j f
jcffab	 j c f f a b
facfdai	 f a c f d a i
dcdjaiafa	 d c d j a i a f a
ecbebjha	 e c b e b j h a
afbfca	 a f b f c a
ecfdgaia	 e c f d g a i a
bj	 b j
bbfcab	 b b f c a b
gic	 g i c
ifbfjf	 i f b f j f
jjiejfb	 j j i e j f b
jbj	 j b j
bjcdccgdd	 b j c d c c g d d
dbbh	 d b b h
chdjcj	 c h d j c j
ggeegeah	 g g e e g e a h
bda	 b d a
dheih	 d h e i h
hebbj	 h e b b j
hhcdgge	 h h c d g g e
icdc	 i c d c
aefbja	 a e f b j a
bcjchacf	 b c j c h a c f
jdbcchfb	 j d b c c h f b
begih	 b e g i h
iicihbcha	 i i c i h b c h a
ijiibh	 i j i i b h
ieghhgcfa	 i e g h h g c f a
fhggeefi	 f h g g e e f i
fjefcggb	 f j e f c g g b
cccjffc	 c c c j f f c
bfcigcjj	 b f c i g c j j
aheibfee	 a h e i b f e e
gjcdf	 g j c d f
ace	 a c e
ihcaa	 i h c a a
hacaaejb	 h a c a a e j b
aacdde	 a a c d d e
idghbg	 i d g h b g
ba	 b a
hecd	 h e c d
fgihagafc	 f g i h a g a f c
ahadj	 a h a d j
cjhba	 c j h b a
befjfdf	 b e f j f d f
jeajihdc	 j e a j i h d c
cfgghchef	 c f g g h c h e f
jgbijbcjc	 j g b i j b c j c
eecih	 e e c i h
djefcff	 d j e f c f f
iaagijaa	 i a a g i j a a
beca	 b e c a
ffcgiib	 f f c g i i b
hcf	 h c f
acbg	 a c b g
bcfadcde	 b c f a d c d e
dceffhhe	 d c e f f h h e
cihbgg	 c i h b g g
gcgeaa	 g c g e a a
egcdfgehi	 e g c d f g e h i
dhag	 d h a g
fffhfb	 f f f h f b
ieeihif	 i e e i h i f
bgejdieb	 b g e j d i e b
ficb	 f i c b
jchbi	 j c h b i
abhbb	 a b h b b
ffde	 f f d e
iac	 i a c
eaifggchj	 e a i f g g c h j
eej	 e e j
dic	 d i c
ihgefdda	 i h g e f d d a
dgecb	 d g e c b
ifid	 i f i d
eie	 e i e
cge	 c g e
cac	 c a c
cahicbdff	 c a h i c b d f f
bdaeidaf	 b d a e i d a f
gei	 g e i
fbddf	 f b d d f
eagf	 e a g f
jfcfba	 j f c f b a
cjjgaaj	 c j j g a a j
cfdiei	 c f d i e i
agch	 a g c h
jbghddhgj	 j b g h d d h g j
bfdbch	 b f d b c h
djhfd	 d j h f d
begddabe	 b e g d d a b e
dcedeg	 d c e d e g
fadb	 f a d b
abcbeg	 a b c b e g
bjd	 b j d
icgihaiij	 i c g i h a i i j
fcaecee	 f c a e c e e
ide	 i d e
hagbdeb	 h a g b d e b
iga	 i g a
fc	 f c
jba	 j b a
ffi	 f f i
fjjd	 f j j d
hdgadgh	 h d g a d g h
hhaghddf	 h h a g h d d f
idjdffcib	 i d j d f f c i b
gji	 g j i
fcfii	 f c f i i
ffc	 f f c
ihibg	 i h i b g
aehdddg	 a e h d d d g
bdiadjgde	 b d i a d j g d e
hied	 h i e d
feb	 f e b
fjje	 f j j e
jga	 j g a
bjc	 b j c
hdadbhi	 h d a d b h i
jd	 j d
bhaj	 b h a j
hc	 h c
agdifjdeh	 a g d i f j d e h
jiccaaece	 j i c c a a e c e
ffbbiih	 f f b b i i h
ddbbfhdgi	 d d b b f h d g i
cjfjcbb	 c j f j c b b
de	 d e
fch	 f c h
gbgdia	 g b g d i a
ai	 a i
jjhd	 j j h d
jdi	 j d i
hdgjdjab	 h d g j d j a b
ahcchecdi	 a h c c h e c d i
abgjge	 a b g j g e
fgbb	 f g b b
ghehi	 g h e h i
hbabhifca	 h b a b h i f c a
jhhjdaca	 j h h j d a c a
dhfdfhbf	 d h f d f h b f
fafa	 f a f a
gf	 g f
dd	 d d
bgfda	 b g f d a
jceig	 j c e i g
cjia	 c j i a
bgha	 b g h a
hfbee	 h f b e e
hcedec	 h c e d e c
heb	 h e b
ajicff	 a j i c f f
dge	 d g e
gjjh	 g j j h
edfb	 e d f b
ge	 g e
deabejce	 d e a b e j c e
igjiaj	 i g j i a j
dbc	 d b c
fhgfaaf	 f h g f a a f
eededeeg	 e e d e d e e g
hcige	 h c i g e
cddhcd	 c d d h c d
da	 d a
hfefci	 h f e f c i
heh	 h e h
cbajagdcb	 c b a j a g d c b
jhedjc	 j h e d j c
bdbjj	 b d b j j
iiiaghbic	 i i i a g h b i c
ge	 g e
gjbdicbf	 g j b d i c b f
cahgfbhhe	 c a h g f b h h e
gah	 g a h
cfc	 c f c
ajbhbhhg	 a j b h b h h g
gbeeca	 g b e e c a
ice	 i c e
dichaf	 d i c h a f
hcghbbjj	 h c g h b b j j
bhddbdcec	 b h d d b d c e c
cbdhdbg	 c b d h d b g
ea	 e a
bcjidfdb	 b c j i d f d b
jj	 j j
efifjae	 e f i f j a e
eedbcgdji	 e e d b c g d j i
ice	 i c e
adichfc	 a d i c h f c
fiege	 f i e g e
gbacfg	 g b a c f g
fbcf	 f b c f
cg	 c g
eahgdhfd	 e a h g d h f d
agcfbaf	 a g c f b a f
bfiffab	 b f i f f a b
hhb	 h h b
adefc	 a d e f c
iigefghgi	 i i g e f g h g i
bcbaadi	 b c b a a d i
daeiadc	 d a e i a d c
eghcbae	 e g h c b a e
hgdh	 h g d h
gc	 g c
cbejb	 c b e j b
eagffb	 e a g f f b
bef	 b e f
aafd	 a a f d
hejafjdf	 h e j a f j d f
eahff	 e a h f f
dca	 d c a
dbf	 d b f
cddcdaj	 c d d c d a j
iaebjc	 i a e b j c
djhi	 d j h i
hfbbc	 h f b b c
iiaiic	 i i a i i c
hc	 h c
cdgcfeaf	 c d g c f e a f
dgahbfa	 d g a h b f a
ejibjd	 e j i b j d
igcf	 i g c f
cigjej	 c i g j e j
geif	 g e i f
ieja	 i e j a
fbg	 f b g
iiejfb	 i i e j f b
bhfjd	 b h f j d
gfb	 g f b
bfd	 b f d
dbfa	 d b f a
afbedc	 a f b e d c
chdhjd	 c h d h j d
dfegbjbaj	 d f e g b j b a j
ajf	 a j f
bc	 b c
dbhb	 d b h b
ibhh	 i b h h
bj	 b j
eebdhadf	 e e b d h a d f
bagiagdc	 b a g i a g d c
fgii	 f g i i
cgcbje	 c g c b j e
ibifi	 i b i f i
jjbgegjdg	 j j b g e g j d g
gejffgdhc	 g e j f f g d h c
hjbjjidch	 h j b j j i d c h
cecb	 c e c b
hcahja	 h c a h j a
giged	 g i g e d
bfi	 b f i
bgghffg	 b g g h f f g
bcce	 b c c e
cdecgbgf	 c d e c g b g f
hcgcac	 h c g c a c
cggjijdc	 c g g j i j d c
cja	 c j a
ig	 i g
jc	 j c
gdd	 g d d
abhde	 a b h d e
fah	 f a h
cgjiabh	 c g j i a b h
ggfjcaab	 g g f j c a a b
ihihcf	 i h i h c f
ec	 e c
dgdga	 d g d g a
ge	 g e
fgji	 f g j i
aha	 a h a
hdbihj	 h d b i h j
jeheibhc	 j e h e i b h c
agcahi	 a g c a h i
bbjifief	 b b j i f i e f
cfdhca	 c f d h c a
giidi	 g i i d i
gf	 g f
edadfjfh	 e d a d f j f h
edgadbcab	 e d g a d b c a b
eb	 e b
efhjgcad	 e f h j g c a d
eifgiagic	 e i f g i a g i c
fhh	 f h h
gb	 g b
dfahgffa	 d f a h g f f a
dhgfdccgf	 d h g f d c c g f
iaciibeg	 i a c i i b e g
be	 b e
jaeea	 j a e e a
befjeh	 b e f j e h
cgbjdfe	 c g b j d f e
ae	 a e
adhji	 a d h j i
abb	 a b b
da	 d a
abijibhi	 a b i j i b h i
ebi	 e b i
aigdbde	 a i g d b d e
jge	 j g e
fd	 f d
efbdeai	 e f b d e a i
gc	 g c
efieded	 e f i e d e d
eaeajfa	 e a e a j f a
eiffdc	 e i f f d c
djbgj	 d j b g j
cd	 c d
agaabfac	 a g a a b f a c
dfdjdfffi	 d f d j d f f f i
djaijg	 d j a i j g
ahccjc	 a h c c j c
iiaa	 i i a a
ah	 a h
chaiebdci	 c h a i e b d c i
cebgdhbbi	 c e b g d h b b i
hceg	 h c e g
hdffbi	 h d f f b i
edjdfi	 e d j d f i
hiaj	 h i a j
fgigfid	 f g i g f i d
bagjae	 b a g j a e
agdj	 a g d j
hacgaed	 h a c g a e d
ja	 j a
bf	 b f
bejece	 b e j e c e
bae	 b a e
igheb	 i g h e b
idb	 i d b
gciaf	 g c i a f
aahebbif	 a a h e b b i f
df	 d f
jggjdiej	 j g g j d i e j
ggjchib	 g g j c h i b
eegjbai	 e e g j b a i
bhf	 b h f
beha	 b e h a
fgj	 f g j
ie	 i e
iiifgadbg	 i i i f g a d b g
ccfj	 c c f j
cjbe	 c j b e
cjhfab	 c j h f a b
aab	 a a b
hfeiad	 h f e i a d
hhjicg	 h h j i c g
bg	 b g
heifhjf	 h e i f h j f
efhiccai	 e f h i c c a i
cffdee	 c f f d e e
eccihi	 e c c i h i
jda	 j d a
bhh	 b h h
dgg	 d g g
ibcehijg	 i b c e h i j g
jgfigbc	 j g f i g b c
dgfgjjiid	 d g f g j j i i d
jji	 j j i
hcj	 h c j
bgacd	 b g a c d
ddc	 d d c
jdacg	 j d a c g
igjibj	 i g j i b j
afchadg	 a f c h a d g
ffejgjd	 f f e j g j d
adbfbd	 a d b f b d
eaddefebe	 e a d d e f e b e
cejc	 c e j c
hdcgdi	 h d c g d i
hhhfjcicd	 h h h f j c i c d
dgcacefb	 d g c a c e f b
ibfi	 i b f i
baefd	 b a e f d
iideb	 i i d e b
jad	 j a d
aaeehdeh	 a a e e h d e h
fegdh	 f e g d h
fbej	 f b e j
cjdjhfi	 c j d j h f i
dhc	 d h c
ifgcdah	 i f g c d a h
hhfjcbee	 h h f j c b e e
hjbhd	 h j b h d
dgb	 d g b
bg	 b g
chjgfbc	 c h j g f b c
gj	 g j
dffbad	 d f f b a d
digcjdi	 d i g c j d i
hjfajca	 h j f a j c a
dgahf	 d g a h f
ijdjja	 i j d j j a
dia	 d i a
ehbb	 e h b b
gaehdbi	 g a e h d b i
gbghciaf	 g b g h c i a f
fcdgbb	 f c d g b b
agf	 a g f
icjjh	 i c j j h
cg	 c g
aeibefj	 a e i b e f j
hjef	 h j e f
eif	 e i f
fedijjgdh	 f e d i j j g d h
cfbd	 c f b d
dejfjb	 d e j f j b
dacbbcea	 d a c b b c e a
acdfd	 a c d f d
eaibhcfjf	 e a i b h c f j f
hhchijee	 h h c h i j e e
efdffi	 e f d f f i
aafgbbf	 a a f g b b f
jffahi	 j f f a h i
efc	 e f c
hgcbei	 h g c b e i
bhaeif	 b h a e i f
hghiefbb	 h g h i e f b b
dcdhebha	 d c d h e b h a
iggdgajhc	 i g g d g a j h c
ddjeag	 d d j e a g
jcej	 j c e j
fjaffi	 f j a f f i
heecjc	 h e e c j c
gbfcjifh	 g b f c j i f h
afcea	 a f c e a
difaieb	 d i f a i e b
dide	 d i d e
hhiahdaf	 h h i a h d a f
bjb	 b j b
fajhgc	 f a j h g c
bghjchhc	 b g h j c h h c
ffc	 f f c
ehecfbc	 e h e c f b c
ehiifgaaa	 e h i i f g a a a
iibjbbi	 i i b j b b i
fgjjchd	 f g j j c h d
hebiac	 h e b i a c
iihb	 i i h b
cfgb	 c f g b
ahcaa	 a h c a a
hdfaigdi	 h d f a i g d i
ccgge	 c c g g e
fe	 f e
fdddcjehf	 f d d d c j e h f
cdbihfheb	 c d b i h f h e b
gdbcahjda	 g d b c a h j d a
bgg	 b g g
cegabi	 c e g a b i
aiacc	 a i a c c
hcachgfjg	 h c a c h g f j g
hgghca	 h g g h c a
gehgab	 g e h g a b
feigj	 f e i g j
adhjib	 a d h j i b
igah	 i g a h
jfdcd	 j f d c d
bg	 b g
fagchgc	 f a g c h g c
jafa	 j a f a
egbiifbj	 e g b i i f b j
gh	 g h
aaae	 a a a e
ejje	 e j j e
jd	 j d
gfdfff	 g f d f f f
ah	 a h
baci	 b a c i
aga	 a g a
dc	 d c
gbcii	 g b c i i
bh	 b h
abjdajbf	 a b j d a j b f
ad	 a d
ggcjhjfeh	 g g c j h j f e h
gghbce	 g g h b c e
fceaj	 f c e a j
hf	 h f
chiabf	 c h i a b f
cc	 c c
gjefd	 g j e f d
diajfd	 d i a j f d
fhgii	 f h g i i
bgdig	 b g d i g
dghgaghed	 d g h g a g h e d
jc	 j c
dfjcfdhaj	 d f j c f d h a j
jiicca	 j i i c c a
bjeibgii	 b j e i b g i i
bhiij	 b h i i j
ibihahejd	 i b i h a h e j d
eahbcc	 e a h b c c
cffbh	 c f f b h
cbib	 c b i b
giaccbcij	 g i a c c b c i j
dihehcij	 d i h e h c i j
hbjgfbgfd	 h b j g f b g f d
cdbiiab	 c d b i i a b
cjfhhbhbh	 c j f h h b h b h
edjcdc	 e d j c d c
ba	 b a
dfcaceg	 d f c a c e g
baifb	 b a i f b
ihibcceei	 i h i b c c e e i
hfbhb	 h f b h b
bbafffd	 b b a f f f d
dggedi	 d g g e d i
ddehiac	 d d e h i a c
fbf	 f b f
ehjabida	 e h j a b i d a
cjb	 c j b
hacdg	 h a c d g
faibchihb	 f a i b c h i h b
baefijd	 b a e f i j d
jf	 j f
dhciia	 d h c i i a
ggdccg	 g g d c c g
eahifbcg	 e a h i f b c g
faac	 f a a c
daagag	 d a a g a g
gidjdg	 g i d j d g
efdbb	 e f d b b
gfjfg	 g f j f g
gcjhj	 g c j h j
bbehbcc	 b b e h b c c
daedieg	 d a e d i e g
jhhahb	 j h h a h b
egejgjh	 e g e j g j h
cdjddhii	 c d j d d h i i
dg	 d g
igcgf	 i g c g f
bdgeac	 b d g e a c
fhiebeij	 f h i e b e i j
ajbbcebgc	 a j b b c e b g c
bgid	 b g i d
heh	 h e h
jj	 j j
fchcib	 f c h c i b
bffbic	 b f f b i c
heici	 h e i c i
bahfibfg	 b a h f i b f g
jbfgjd	 j b f g j d
hjbbigef	 h j b b i g e f
bgedbfd	 b g e d b f d
cahjhigbh	 c a h j h i g b h
fj	 f j
jeeh	 j e e h
cbd	 c b d
cbbghbjh	 c b b g h b j h
jfcdgijg	 j f c d g i j g
faahgh	 f a a h g h
heccbbj	 h e c c b b j
ffbgfj	 f f b g f j
jfgdbj	 j f g d b j
daagj	 d a a g j
jeffdjcfa	 j e f f d j c f a
iajigibha	 i a j i g i b h a
jijdg	 j i j d g
ghabicdhi	 g h a b i c d h i
ffjiccgij	 f f j i c c g i j
ifedibg	 i f e d i b g
facdaeega	 f a c d a e e g a
aabeaff	 a a b e a f f
ebejagbag	 e b e j a g b a g
gdjfhhbgi	 g d j f h h b g i
fbhg	 f b h g
agfhhidee	 a g f h h i d e e
ffbigdgaj	 f f b i g d g a j
eiehahf	 e i e h a h f
gegh	 g e g h
fdebjedag	 f d e b j e d a g
diahdichb	 d i a h d i c h b
bajbce	 b a j b c e
afdfhe	 a f d f h e
jjjbgdh	 j j j b g d h
aeabjhee	 a e a b j h e e
ggjfdic	 g g j f d i c
dhf	 d h f
jb	 j b
gg	 g g
egdffaije	 e g d f f a i j e
fjecgfih	 f j e c g f i h
dffhhfed	 d f f h h f e d
jbhccic	 j b h c c i c
hhhge	 h h h g e
cidijgh	 c i d i j g h
biifjdbh	 b i i f j d b h
gacjga	 g a c j g a
ae	 a e
idb	 i d b
egg	 e g g
cgccffcdh	 c g c c f f c d h
fabdccje	 f a b d c c j e
ecgbii	 e c g b i i
ahcijjhe	 a h c i j j h e
badddd	 b a d d d d
ffcdhigd	 f f c d h i g d
ib	 i b
daa	 d a a
ddciba	 d d c i b a
dchac	 d c h a c
cbeefca	 c b e e f c a
ejhhj	 e j h h j
cbd	 c b d
dc	 d c
dj	 d j
gcjjefcji	 g c j j e f c j i
ggedj	 g g e d j
bedeg	 b e d e g
hjh	 h j h
ia	 i a
gf	 g f
hdhefja	 h d h e f j a
hi	 h i
hgbah	 h g b a h
ca	 c a
gcigfff	 g c i g f f f
gi	 g i
bfieg	 b f i e g
gajgbfd	 g a j g b f d
iecf	 i e c f
gg	 g g
bfccdc	 b f c c d c
ijeedgbc	 i j e e d g b c
idfjbide	 i d f j b i d e
fhhjee	 f h h j e e
hihhhaejd	 h i h h h a e j d
ebddhhih	 e b d d h h i h
cieb	 c i e b
gje	 g j e
gfefa	 g f e f a
gj	 g j
gh	 g h
eg	 e g
fabafgbh	 f a b a f g b h
gbiabhj	 g b i a b h j
ihihdi	 i h i h d i
djhi	 d j h i
eijjjc	 e i j j j c
gdhfhjcga	 g d h f h j c g a
dajjigjh	 d a j j i g j h
bjhacheeh	 b j h a c h e e h
cggbhccaf	 c g g b h c c a f
beg	 b e g
dehfgjhfe	 d e h f g j h f e
cjd	 c j d
bdaf	 b d a f
hdebeejhi	 h d e b e e j h i
ib	 i b
gehffdaej	 g e h f f d a e j
fdjc	 f d j c
dddga	 d d d g a
iiidcgb	 i i i d c g b
cegc	 c e g c
daiacc	 d a i a c c
cdicddjbi	 c d i c d d j b i
ca	 c a
cgjchedhd	 c g j c h e d h d
ahidagffj	 a h i d a g f f j
ifeafe	 i f e a f e
jdaabjjbf	 j d a a b j j b f
gfhcf	 g f h c f
hdchjad	 h d c h j a d
idi	 i d i
hbih	 h b i h
gfc	 g f c
cgeb	 c g e b
fdgchd	 f d g c h d
ccfjgac	 c c f j g a c
jjjdjhe	 j j j d j h e
dbfgfc	 d b f g f c
ceg	 c e g
jhjffbb	 j h j f f b b
ccjgh	 c c j g h
gaggh	 g a g g h
heeacjij	 h e e a c j i j
jbiijjggb	 j b i i j j g g b
fgaaaacbi	 f g a a a a c b i
cc	 c c
if	 i f
ebhfehc	 e b h f e h c
hjdh	 h j d h
eaiejdced	 e a i e j d c e d
ge	 g e
ggdb	 g g d b
agibdeh	 a g i b d e h
jdea	 j d e a
deege	 d e e g e
jdahfhdd	 j d a h f h d d
eagbiicic	 e a g b i i c i c
jgbjcj	 j g b j c j
bcigabjd	 b c i g a b j d
bhbig	 b h b i g
aigh	 a i g h
gecde	 g e c d e
jihbjib	 j i h b j i b
fiadbc	 f i a d b c
fedbjeh	 f e d b j e h
abid	 a b i d
jaedfdfg	 j a e d f d f g
ejii	 e j i i
jf	 j f
bgfbga	 b g f b g a
hdfbdigej	 h d f b d i g e j
cffdgf	 c f f d g f
gfecf	 g f e c f
cgghhcb	 c g g h h c b
djfdcehbi	 d j f d c e h b i
aafjdcfcd	 a a f j d c f c d
ihhahhji	 i h h a h h j i
aeaa	 a e a a
hbbiefjg	 h b b i e f j g
bhe	 b h e
bdgd	 b d g d
bfebbe	 b f e b b e
af	 a f
ha	 h a
dihfjh	 d i h f j h
fcbjb	 f c b j b
cbgj	 c b g j
dh	 d h
fb	 f b
dceifddi	 d c e i f d d i
jgggi	 j g g g i
ccacidhb	 c c a c i d h b
fg	 f g
hcciifc	 h c c i i f c
chgfbehj	 c h g f b e h j
ajcjff	 a j c j f f
di	 d i
cifgef	 c i f g e f
jfdjg	 j f d j g
ac	 a c
jfgefai	 j f g e f a i
aahaa	 a a h a a
biiiff	 b i i i f f
ihiig	 i h i i g
ibahah	 i b a h a h
jbegbe	 j b e g b e
deddbhhh	 d e d d b h h h
ag	 a g
iahgd	 i a h g d
ecafghcd	 e c a f g h c d
dahabbeje	 d a h a b b e j e
jbdgdi	 j b d g d i
jjgdhjjc	 j j g d h j j c
jfgbcgj	 j f g b c g j
ajcjh	 a j c j h
bafbhai	 b a f b h a i
ahabahci	 a h a b a h c i
hebdggd	 h e b d g g d
bbgbd	 b b g b d
bjghbhg	 b j g h b h g
bhddgh	 b h d d g h
hahehaee	 h a h e h a e e
ihf	 i h f
ididji	 i d i d j i
efbaicd	 e f b a i c d
hdgh	 h d g h
cafagfd	 c a f a g f d
cfbibc	 c f b i b c
aghajfi	 a g h a j f i
diifaa	 d i i f a a
fi	 f i
adbbef	 a d b b e f
gehbddai	 g e h b d d a i
ah	 a h
fafidad	 f a f i d a d
edifccgij	 e d i f c c g i j
faabgfd	 f a a b g f d
beijf	 b e i j f
af	 a f
jbggdieea	 j b g g d i e e a
bg	 b g
bgcbc	 b g c b c
idbieeijj	 i d b i e e i j j
dc	 d c
eaaahicdi	 e a a a h i c d i
cdcce	 c d c c e
af	 a f
jahaeg	 j a h a e g
gagaca	 g a g a c a
gddiiehg	 g d d i i e h g
ajeghcfhb	 a j e g h c f h b
ggc	 g g c
ib	 i b
ccedhfg	 c c e d h f g
ia	 i a
jcica	 j c i c a
gdfg	 g d f g
dcdffe	 d c d f f e
cigjieagj	 c i g j i e a g j
da	 d a
hiaah	 h i a a h
bg	 b g
difihhfc	 d i f i h h f c
ciajejadh	 c i a j e j a d h
jedgea	 j e d g e a
jhdechji	 j h d e c h j i
aibejb	 a i b e j b
fci	 f c i
eeiifccd	 e e i i f c c d
dcdd	 d c d d
gdff	 g d f f
cbejg	 c b e j g
djci	 d j c i
dahdjehg	 d a h d j e h g
jjbgc	 j j b g c
fccj	 f c c j
fg	 f g
gid	 g i d
cchjdji	 c c h j d j i
ccd	 c c d
gibcdi	 g i b c d i
eec	 e e c
hcjhb	 h c j h b
acg	 a c g
de	 d e
hgaedfhc	 h g a e d f h c
jh	 j h
jjfbfj	 j j f b f j
geefhehh	 g e e f h e h h
jddeaec	 j d d e a e c
ieababj	 i e a b a b j
hej	 h e j
hjacfhe	 h j a c f h e
agc	 a g c
ijjdaj	 i j j d a j
hh	 h h
heciebjb	 h e c i e b j b
dfaiijdf	 d f a i i j d f
ih	 i h
dbjjghcfg	 d b j j g h c f g
jcb	 j c b
da	 d a
bf	 b f
afbfd	 a f b f d
eajd	 e a j d
bcii	 b c i i
iddhdbb	 i d d h d b b
bdgfh	 b d g f h
chfcj	 c h f c j
fjeacbi	 f j e a c b i
heiigihf	 h e i i g i h f
fgfccdi	 f g f c c d i
hbhd	 h b h d
cbafgc	 c b a f g c
jfbc	 j f b c
ehd	 e h d
dhjghjgfe	 d h j g h j g f e
accdeibic	 a c c d e i b i c
fga	 f g a
abj	 a b j
ghjg	 g h j g
bfecfb	 b f e c f b
ibagieeij	 i b a g i e e i j
adffci	 a d f f c i
fiadfgca	 f i a d f g c a
chccaecc	 c h c c a e c c
ge	 g e
bgb	 b g b
hef	 h e f
bfhaje	 b f h a j e
fjaaehif	 f j a a e h i f
bjachba	 b j a c h b a
ihgfhh	 i h g f h h
fb	 f b
hcd	 h c d
dbjf	 d b j f
gcgicjig	 g c g i c j i g
aceci	 a c e c i
djihjh	 d j i h j h
jciahe	 j c i a h e
ciieefjjj	 c i i e e f j j j
becbjibcd	 b e c b j i b c d
iejg	 i e j g
fidj	 f i d j
jacf	 j a c f
fadhddg	 f a d h d d g
dehbdc	 d e h b d c
fejjcdhab	 f e j j c d h a b
fijfihgi	 f i j f i h g i
ebef	 e b e f
hgbgb	 h g b g b
acjjjhbb	 a c j j j h b b
abea	 a b e a
bbe	 b b e
bj	 b j
debdhjdd	 d e b d h j d d
fiffbdc	 f i f f b d c
dbbbfgefh	 d b b b f g e f h
afaa	 a f a a
jighaabgh	 j i g h a a b g h
hijijceg	 h i j i j c e g
jiia	 j i i a
hid	 h i d
jjjigic	 j j j i g i c
bafccebed	 b a f c c e b e d
bi	 b i
ii	 i i
eihae	 e i h a e
gjadbhg	 g j a d b h g
ab	 a b
eihgi	 e i h g i
cjibcched	 c j i b c c h e d
bagafhhgi	 b a g a f h h g i
cbeeaddh	 c b e e a d d h
dicdagja	 d i c d a g j a
hdgdbhfbh	 h d g d b h f b h
bjhebgdi	 b j h e b g d i
bffiidh	 b f f i i d h
bagccaebh	 b a g c c a e b h
ehbg	 e h b g
dhfbihb	 d h f b i h b
edbbgj	 e d b b g j
jj	 j j
dhdea	 d h d e a
hcd	 h c d
chdiha	 c h d i h a
adggh	 a d g g h
ega	 e g a
ddedghgje	 d d e d g h g j e
gdbbjbbf	 g d b b j b b f
cbbccbji	 c b b c c b j i
jfa	 j f a
ifbc	 i f b c
eebjabhae	 e e b j a b h a e
fej	 f e j
aajhgjedj	 a a j h g j e d j
dgd	 d g d
gjacjfe	 g j a c j f e
higg	 h i g g
gaagjdg	 g a a g j d g
egibddajb	 e g i b d d a j b
bdg	 b d g
cddb	 c d d b
ib	 i b
dcj	 d c j
caiga	 c a i g a
fijgech	 f i j g e c h
cigfd	 c i g f d
agcjcbb	 a g c j c b b
giae	 g i a e
gggiabfff	 g g g i a b f f f
dhjebhc	 d h j e b h c
dbhibb	 d b h i b b
fafe	 f a f e
fcj	 f c j
ei	 e i
cfbaaci	 c f b a a c i
egagf	 e g a g f
egcdjg	 e g c d j g
jhibjce	 j h i b j c e
fbbfb	 f b b f b
gde	 g d e
dfbagehhc	 d f b a g e h h c
jfg	 j f g
bc	 b c
bfhc	 b f h c
gbdacgahb	 g b d a c g a h b
hbab	 h b a b
gggeehhdc	 g g g e e h h d c
cjddbf	 c j d d b f
fgdaigb	 f g d a i g b
bjgch	 b j g c h
facj	 f a c j
egibgee	 e g i b g e e
fhde	 f h d e
ifijaigee	 i f i j a i g e e
becdfg	 b e c d f g
iddifafha	 i d d i f a f h a
bejjgj	 b e j j g j
fhagjcieb	 f h a g j c i e b
hifgcb	 h i f g c b
bceeiggfi	 b c e e i g g f i
bg	 b g
behfdfag	 b e h f d f a g
eeddbch	 e e d d b c h
dciigjgi	 d c i i g j g i
jibbaj	 j i b b a j
fja	 f j a
eiacc	 e i a c c
ibce	 i b c e
bdch	 b d c h
cdfaf	 c d f a f
acj	 a c j
jcbdbige	 j c b d b i g e
bcdiaheae	 b c d i a h e a e
cbgiagbdb	 c b g i a g b d b
jbadfjf	 j b a d f j f
jejbicij	 j e j b i c i j
gfehga	 g f e h g a
dc	 d c
ei	 e i
fg	 f g
bi	 b i
be	 b e
ebdc	 e b d c
ahbgjfbd	 a h b g j f b d
iiei	 i i e i
cecf	 c e c f
icd	 i c d
jfeiihb	 j f e i i h b
jicigdc	 j i c i g d c
ichihibf	 i c h i h i b f
ajagfd	 a j a g f d
acdhhdfb	 a c d h h d f b
edieejd	 e d i e e j d
bggbbijh	 b g g b b i j h
aidaghjia	 a i d a g h j i a
id	 i d
ae	 a e
ibgd	 i b g d
hc	 h c
baehfhibi	 b a e h f h i b i
iecj	 i e c j
jbe	 j b e
eif	 e i f
fdcd	 f d c d
bbccfj	 b b c c f j
hj	 h j
dfbg	 d f b g
aia	 a i a
iddbcbbb	 i d d b c b b b
hhf	 h h f
cjeahadbc	 c j e a h a d b c
adhch	 a d h c h
hddf	 h d d f
cbd	 c b d
cdjjgif	 c d j j g i f
fibc	 f i b c
cfaeaebhg	 c f a e a e b h g
hhheiedif	 h h h e i e d i f
iibhgjj	 i i b h g j j
eagiefc	 e a g i e f c
eaaddhhf	 e a a d d h h f
egbcagehf	 e g b c a g e h f
ieicbeagd	 i e i c b e a g d
caegjgjb	 c a e g j g j b
ageaa	 a g e a a
ghccd	 g h c c d
edaahhdi	 e d a a h h d i
gd	 g d
eaha	 e a h a
ijhc	 i j h c
cheibd	 c h e i b d
fjjdabj	 f j j d a b j
jccaafd	 j c c a a f d
eafhcdee	 e a f h c d e e
jbdjjjai	 j b d j j j a i
iifj	 i i f j
cjda	 c j d a
ea	 e a
bhiacde	 b h i a c d e
ihaefd	 i h a e f d
bh	 b h
ehdbddibf	 e h d b d d i b f
fidhdibd	 f i d h d i b d
jaccdcic	 j a c c d c i c
jhhbabgh	 j h h b a b g h
gjah	 g j a h
dbffcih	 d b f f c i h
hbgiebh	 h b g i e b h
edbjia	 e d b j i a
aj	 a j
jj	 j j
bejjf	 b e j j f
eecacich	 e e c a c i c h
cgg	 c g g
gifjjacb	 g i f j j a c b
bab	 b a b
hgee	 h g e e
ij	 i j
ge	 g e
gdjagd	 g d j a g d
iibh	 i i b h
iej	 i e j
ffffji	 f f f f j i
icbjbja	 i c b j b j a
jh	 j h
gdcj	 g d c j
gdd	 g d d
gfjcdbhib	 g f j c d b h i b
id	 i d
eai	 e a i
ge	 g e
dh	 d h
fde	 f d e
fhah	 f h a h
ddfjca	 d d f j c a
jch	 j c h
cicbb	 c i c b b
jida	 j i d a
bcd	 b c d
bijhecf	 b i j h e c f
aicfgfdj	 a i c f g f d j
egffiefe	 e g f f i e f e
cbaejedg	 c b a e j e d g
cjchbdeg	 c j c h b d e g
fbgj	 f b g j
dajbac	 d a j b a c
ga	 g a
bje	 b j e
ib	 i b
dfccagh	 d f c c a g h
bcbgigec	 b c b g i g e c
feiahdd	 f e i a h d d
fd	 f d
gghc	 g g h c
hhah	 h h a h
hbjd	 h b j d
igba	 i g b a
aahb	 a a h b
dbefh	 d b e f h
ebhca	 e b h c a
aeahfh	 a e a h f h
jhfiegad	 j h f i e g a d
bcehifcai	 b c e h i f c a i
dcdegaijg	 d c d e g a i j g
aabid	 a a b i d
fcged	 f c g e d
iaiba	 i a i b a
aga	 a g a
dibcigia	 d i b c i g i a
bdbfihifb	 b d b f i h i f b
ad	 a d
ifciiefdg	 i f c i i e f d g
hdadee	 h d a d e e
cfbahcbcj	 c f b a h c b c j
hdha	 h d h a
iahc	 i a h c
dadff	 d a d f f
fbiiaffff	 f b i i a f f f f
caiicd	 c a i i c d
ddgij	 d d g i j
jbjga	 j b j g a
agdgiiabi	 a g d g i i a b i
ifgcdjeia	 i f g c d j e i a
eehaedg	 e e h a e d g
gci	 g c i
cdgjhdcbg	 c d g j h d c b g
hg	 h g
ggddeae	 g g d d e a e
jbhabi	 j b h a b i
heifhbadi	 h e i f h b a d i
dbfbijgd	 d b f b i j g d
abgbefi	 a b g b e f i
bbgbi	 b b g b i
beechb	 b e e c h b
cjda	 c j d a
ehehghcei	 e h e h g h c e i
bhcfhbh	 b h c f h b h
gi	 g i
ejhdd	 e j h d d
jifj	 j i f j
ig	 i g
hbeic	 h b e i c
ga	 g a
ijd	 i j d
ffaajbafh	 f f a a j b a f h
eajdhce	 e a j d h c e
fffbich	 f f f b i c h
iihai	 i i h a i
hjhbgbcig	 h j h b g b c i g
aidfibchg	 a i d f i b c h g
jfdbfa	 j f d b f a
dejeajed	 d e j e a j e d
bc	 b c
jbhib	 j b h i b
ihcb	 i h c b
eddjcc	 e d d j c c
dc	 d c
dgfgfi	 d g f g f i
cedbic	 c e d b i c
gjdacbd	 g j d a c b d
hi	 h i
ddbcd	 d d b c d
fabhbhchd	 f a b h b h c h d
hbdgicgg	 h b d g i c g g
egbedihg	 e g b e d i h g
adb	 a d b
fehfij	 f e h f i j
igech	 i g e c h
ajahadia	 a j a h a d i a
bhcgjdhfd	 b h c g j d h f d
jgjj	 j g j j
ejcdgacje	 e j c d g a c j e
fhaaie	 f h a a i e
hheijefa	 h h e i j e f a
dffcjj	 d f f c j j
ggec	 g g e c
ejfgaage	 e j f g a a g e
djcjhjddc	 d j c j h j d d c
fi	 f i
gaahbbbei	 g a a h b b b e i
fd	 f d
fjehgdjc	 f j e h g d j c
bijfhgace	 b i j f h g a c e
beh	 b e h
dbecfec	 d b e c f e c
dd	 d d
jeh	 j e h
gjgd	 g j g d
fhdabc	 f h d a b c
ajdifhae	 a j d i f h a e
ibia	 i b i a
hch	 h c h
bagi	 b a g i
fgijacada	 f g i j a c a d a
ffh	 f f h
eadci	 e a d c i
hjcg	 h j c g
fha	 f h a
iieh	 i i e h
gih	 g i h
dajcbd	 d a j c b d
hehf	 h e h f
ee	 e e
ccejfehjf	 c c e j f e h j f
bje	 b j e
dje	 d j e
hggh	 h g g h
cca	 c c a
digc	 d i g c
cijdidi	 c i j d i d i
ch	 c h
dffggfbg	 d f f g g f b g
bhg	 b h g
ibhfhebh	 i b h f h e b h
edeecb	 e d e e c b
ia	 i a
fdfifhc	 f d f i f h c
cgda	 c g d a
hicdcacag	 h i c d c a c a g
efeabdjb	 e f e a b d j b
agfaa	 a g f a a
jhhjdd	 j h h j d d
gbdbdd	 g b d b d d
faacgch	 f a a c g c h
iabgj	 i a b g j
ebhcde	 e b h c d e
hfifje	 h f i f j e
bbbbeh	 b b b b e h
fg	 f g
bihgegge	 b i h g e g g e
jccf	 j c c f
bfgjhgaib	 b f g j h g a i b
ec	 e c
dccchfj	 d c c c h f j
jai	 j a i
ebdi	 e b d i
ibadghgie	 i b a d g h g i e
ajb	 a j b
cabahiedd	 c a b a h i e d d
gjb	 g j b
ebighghf	 e b i g h g h f
if	 i f
ic	 i c
jci	 j c i
ghbecaegg	 g h b e c a e g g
eaefhh	 e a e f h h
aehcfehga	 a e h c f e h g a
dff	 d f f
gc	 g c
hfief	 h f i e f
gegh	 g e g h
hiabig	 h i a b i g
fjaifffce	 f j a i f f f c e
jcdbai	 j c d b a i
ea	 e a
eaacc	 e a a c c
iaaaa	 i a a a a
aibgebb	 a i b g e b b
jdj	 j d j
dfhfiibaf	 d f h f i i b a f
ebfde	 e b f d e
heej	 h e e j
jdhejh	 j d h e j h
jfifdb	 j f i f d b
dfhefdha	 d f h e f d h a
bihajf	 b i h a j f
giajicdfd	 g i a j i c d f d
acjhe	 a c j h e
heeiaa	 h e e i a a
cbcgfejc	 c b c g f e j c
gjeaaf	 g j e a a f
efi	 e f i
iabchfad	 i a b c h f a d
hfeidi	 h f e i d i
af	 a f
eja	 e j a
hba	 h b a
heabeice	 h e a b e i c e
fdfc	 f d f c
hc	 h c
iieaiafj	 i i e a i a f j
ddhcjdc	 d d h c j d c
cgic	 c g i c
jjefaic	 j j e f a i c
bfae	 b f a e
iihgh	 i i h g h
hb	 h b
efbhgafe	 e f b h g a f e
aijbdfc	 a i j b d f c
afe	 a f e
gadfbhc	 g a d f b h c
ecf	 e c f
jeaj	 j e a j
ijeahdfg	 i j e a h d f g
agdch	 a g d c h
fg	 f g
iigiib	 i i g i i b
hfjghiahi	 h f j g h i a h i
haij	 h a i j
bcghedbi	 b c g h e d b i
decehgb	 d e c e h g b
ifaga	 i f a g a
idegj	 i d e g j
dhdh	 d h d h
fdij	 f d i j
cbifc	 c b i f c
chahdeei	 c h a h d e e i
aefeeacaa	 a e f e e a c a a
haedbe	 h a e d b e
aa	 a a
cjhc	 c j h c
dege	 d e g e
eie	 e i e
dcacgh	 d c a c g h
defhbfbhf	 d e f h b f b h f
beaebhjcc	 b e a e b h j c c
aefgefee	 a e f g e f e e
icicd	 i c i c d
ef	 e f
gabhbbecj	 g a b h b b e c j
heai	 h e a i
hbcibj	 h b c i b j
dgifi	 d g i f i
dfhbafj	 d f h b a f j
bghfeeda	 b g h f e e d a
gjag	 g j a g
fj	 f j
adgfbg	 a d g f b g
eeidcfa	 e e i d c f a
ffggc	 f f g g c
fdhbbgff	 f d h b b g f f
bgjac	 b g j a c
cjidi	 c j i d i
dbcaea	 d b c a e a
hjhe	 h j h e
gjbhid	 g j b h i d
bfbjdejcc	 b f b j d e j c c
acjd	 a c j d
ggec	 g g e c
eghgfccbj	 e g h g f c c b j
hecegji	 h e c e g j i
egijdehhg	 e g i j d e h h g
iiceg	 i i c e g
hcchdfj	 h c c h d f j
jchgjeejd	 j c h g j e e j d
jifheh	 j i f h e h
hijbebca	 h i j b e b c a
ff	 f f
ggcccj	 g g c c c j
diegd	 d i e g d
iijgbijh	 i i j g b i j h
dhff	 d h f f
idgedj	 i d g e d j
cfehijahi	 c f e h i j a h i
iecdicbg	 i e c d i c b g
jfj	 j f j
gjfjdgcdi	 g j f j d g c d i
jjaj	 j j a j
jajbb	 j a j b b
cbjhh	 c b j h h
fgdia	 f g d i a
beiafjf	 b e i a f j f
ecdigjiii	 e c d i g j i i i
jbc	 j b c
jcaga	 j c a g a
gfcf	 g f c f
fjbbccbag	 f j b b c c b a g
hecca	 h e c c a
ib	 i b
iifc	 i i f c
hi	 h i
gdfhach	 g d f h a c h
ah	 a h
jccieajbg	 j c c i e a j b g
gifjjhjh	 g i f j j h j h
df	 d f
cgg	 c g g
deecji	 d e e c j i
ggbc	 g g b c
bhigfje	 b h i g f j e
hgfc	 h g f c
adjjjecag	 a d j j j e c a g
aaeaiaa	 a a e a i a a
fbihh	 f b i h h
hj	 h j
agcfcbcc	 a g c f c b c c
fghfcbb	 f g h f c b b
eccdg	 e c c d g
hc	 h c
hcfjh	 h c f j h
fiaccaa	 f i a c c a a
fcf	 f c f
bga	 b g a
hfcjf	 h f c j f
aiihgei	 a i i h g e i
hg	 h g
hgdhebc	 h g d h e b c
bjfgfeid	 b j f g f e i d
hcaj	 h c a j
df	 d f
gdajac	 g d a j a c
hcaicehgb	 h c a i c e h g b
fjchbieb	 f j c h b i e b
hbcef	 h b c e f
ficdchii	 f i c d c h i i
icbb	 i c b b
cihhhjj	 c i h h h j j
ef	 e f
dg	 d g
ghcha	 g h c h a
affeadgde	 a f f e a d g d e
cibihe	 c i b i h e
jjg	 j j g
ifhgf	 i f h g f
adfcfdg	 a d f c f d g
if	 i f
gjegfcc	 g j e g f c c
jd	 j d
abffeaa	 a b f f e a a
iag	 i a g
jdbjd	 j d b j d
jheiibeg	 j h e i i b e g
bdgaggbii	 b d g a g g b i i
hbhcihba	 h b h c i h b a
ficcaahgb	 f i c c a a h g b
ifbjai	 i f b j a i
cdffaead	 c d f f a e a d
hjjgegg	 h j j g e g g
ddgggaeb	 d d g g g a e b
aaidgi	 a a i d g i
hh	 h h
gfadheg	 g f a d h e g
eejf	 e e j f
eidbib	 e i d b i b
ageeeagdi	 a g e e e a g d i
eeegeebfh	 e e e g e e b f h
eecg	 e e c g
gfgabjifg	 g f g a b j i f g
dcdjhjj	 d c d j h j j
ca	 c a
bchg	 b c h g
jchi	 j c h i
ceefhiai	 c e e f h i a i
fbghfjdcc	 f b g h f j d c c
dadfccib	 d a d f c c i b
hbjbffajd	 h b j b f f a j d
fihbahjec	 f i h b a h j e c
be	 b e
abchfii	 a b c h f i i
ijgdjb	 i j g d j b
cjijaccd	 c j i j a c c d
jjigbgdd	 j j i g b g d d
ffaegei	 f f a e g e i
ajggfdaec	 a j g g f d a e c
jcihg	 j c i h g
bacd	 b a c d
hb	 h b
bcciahfdi	 b c c i a h f d i
fjahi	 f j a h i
bhaijichb	 b h a i j i c h b
idbgaaica	 i d b g a a i c a
ic	 i c
dfdacf	 d f d a c f
cja	 c j a
fahe	 f a h e
hgdbgbhc	 h g d b g b h c
abbj	 a b b j
hahad	 h a h a d
afbje	 a f b j e
hdjfdde	 h d j f d d e
hchb	 h c h b
ddgjfhfbe	 d d g j f h f b e
jg	 j g
ehj	 e h j
iiai	 i i a i
fcfh	 f c f h
dgbid	 d g b i d
gf	 g f
chg	 c h g
hjdgigf	 h j d g i g f
hadijhhc	 h a d i j h h c
eihg	 e i h g
dfhjceh	 d f h j c e h
jhcahea	 j h c a h e a
bjah	 b j a h
ija	 i j a
hgibjgd	 h g i b j g d
hadf	 h a d f
egcj	 e g c j
fejaif	 f e j a i f
gfcdhfc	 g f c d h f c
igjhf	 i g j h f
fidfjeh	 f i d f j e h
eid	 e i d
jdjggccf	 j d j g g c c f
hhcccfb	 h h c c c f b
bbcidhcg	 b b c i d h c g
aadehdddb	 a a d e h d d d b
dd	 d d
ebfcgi	 e b f c g i
aaaadfhi	 a a a a d f h i
didhhg	 d i d h h g
eaicddb	 e a i c d d b
cbdddffee	 c b d d d f f e e
jaigjcdhd	 j a i g j c d h d
ccegi	 c c e g i
fdfedfdi	 f d f e d f d i
abeie	 a b e i e
fcfj	 f c f j
idiaejca	 i d i a e j c a
ea	 e a
ac	 a c
ibcbddaic	 i b c b d d a i c
hhcb	 h h c b
jd	 j d
jejaejece	 j e j a e j e c e
cbabhbh	 c b a b h b h
fchebgcce	 f c h e b g c c e
hfdccjbaj	 h f d c c j b a j
cggjifbb	 c g g j i f b b
edahe	 e d a h e
fgdbjf	 f g d b j f
hifhbb	 h i f h b b
ihgfgg	 i h g f g g
gd	 g d
ejgdicc	 e j g d i c c
ciagj	 c i a g j
bidab	 b i d a b
hjb	 h j b
gci	 g c i
aci	 a c i
gffi	 g f f i
cag	 c a g
hda	 h d a
cjacg	 c j a c g
if	 i f
ifgjbicd	 i f g j b i c d
agba	 a g b a
fjifdbe	 f j i f d b e
dhbcaac	 d h b c a a c
dgj	 d g j
gghdae	 g g h d a e
difd	 d i f d
bfgj	 b f g j
djjdga	 d j j d g a
fda	 f d a
hidhef	 h i d h e f
ead	 e a d
hbijci	 h b i j c i
gjdagbe	 g j d a g b e
aihihcjdh	 a i h i h c j d h
iaebbchb	 i a e b b c h b
eeiaa	 e e i a a
ff	 f f
ige	 i g e
aagejh	 a a g e j h
heghd	 h e g h d
faebjadhe	 f a e b j a d h e
bf	 b f
abjhabd	 a b j h a b d
dba	 d b a
ddcjc	 d d c j c
dg	 d g
aheeaadjf	 a h e e a a d j f
ibb	 i b b
cdfeiih	 c d f e i i h
ffbgggi	 f f b g g g i
bgfhdib	 b g f h d i b
idbhjbe	 i d b h j b e
eegehg	 e e g e h g
dahdfafif	 d a h d f a f i f
bejhidg	 b e j h i d g
gdece	 g d e c e
eddgde	 e d d g d e
bchief	 b c h i e f
adgg	 a d g g
die	 d i e
fhifdidcc	 f h i f d i d c c
bdfaededg	 b d f a e d e d g
icef	 i c e f
jfej	 j f e j
jbd	 j b d
hcddfffde	 h c d d f f f d e
ijefgaa	 i j e f g a a
hi	 h i
edec	 e d e c
ccdg	 c c d g
eacei	 e a c e i
jgfgffgg	 j g f g f f g g
diaegihhi	 d i a e g i h h i
ehcccbf	 e h c c c b f
dabc	 d a b c
ff	 f f
iaghice	 i a g h i c e
hdagd	 h d a g d
jfeed	 j f e e d
aeh	 a e h
gb	 g b
fd	 f d
hcfaacjh	 h c f a a c j h
jh	 j h
dgiec	 d g i e c
fga	 f g a
cdbfhg	 c d b f h g
jjidd	 j j i d d
gbig	 g b i g
jhh	 j h h
aebfje	 a e b f j e
faia	 f a i a
ccij	 c c i j
ageejfc	 a g e e j f c
cfif	 c f i f
ga	 g a
ach	 a c h
fjhefdf	 f j h e f d f
feb	 f e b
jdi	 j d i
hdhgecj	 h d h g e c j
gfbjegb	 g f b j e g b
ajd	 a j d
heaicebj	 h e a i c e b j
jbh	 j b h
ebgibcgia	 e b g i b c g i a
efggjjcgg	 e f g g j j c g g
hid	 h i d
ebh	 e b h
hdiiiii	 h d i i i i i
jbcj	 j b c j
bcb	 b c b
ibacchgc	 i b a c c h g c
gbighj	 g b i g h j
hgde	 h g d e
fhbabe	 f h b a b e
ficgic	 f i c g i c
giiffddbj	 g i i f f d d b j
if	 i f
dijfceb	 d i j f c e b
bbch	 b b c h
gbd	 g b d
be	 b e
jfgd	 j f g d
bhegj	 b h e g j
ijebf	 i j e b f
aj	 a j
dchjfj	 d c h j f j
dejdf	 d e j d f
jfa	 j f a
ijgcegc	 i j g c e g c
efahgfii	 e f a h g f i i
bdcdaf	 b d c d a f
cbj	 c b j
iigbhbhf	 i i g b h b h f
afgagj	 a f g a g j
cbhejhc	 c b h e j h c
fbhcd	 f b h c d
fefggcdai	 f e f g g c d a i
bjdabehc	 b j d a b e h c
ddh	 d d h
abhadi	 a b h a d i
hgcbgei	 h g c b g e i
ciah	 c i a h
efgfffiif	 e f g f f f i i f
cdbfbhag	 c d b f b h a g
ejihif	 e j i h i f
fcbaha	 f c b a h a
badgdchdj	 b a d g d c h d j
aajggdif	 a a j g g d i f
fiji	 f i j i
ifaagbidc	 i f a a g b i d c
bh	 b h
cbfi	 c b f i
hj	 h j
gcfgjcjb	 g c f g j c j b
iii	 i i i
cjhgfi	 c j h g f i
hjfcaji	 h j f c a j i
ahecejff	 a h e c e j f f
abde	 a b d e
hghibh	 h g h i b h
gicgjf	 g i c g j f
ej	 e j
difdfig	 d i f d f i g
eiccihjga	 e i c c i h j g a
hc	 h c
ageacc	 a g e a c c
aahgj	 a a h g j
bhedciiee	 b h e d c i i e e
fibjhh	 f i b j h h
heeifbf	 h e e i f b f
becije	 b e c i j e
ffhac	 f f h a c
gjj	 g j j
ifacdfgcg	 i f a c d f g c g
ibageief	 i b a g e i e f
fccddeb	 f c c d d e b
fhjbi	 f h j b i
feca	 f e c a
gbjfhege	 g b j f h e g e
iieea	 i i e e a
ajacf	 a j a c f
di	 d i
heegd	 h e e g d
hjajcb	 h j a j c b
jhc	 j h c
jgidjcdfa	 j g i d j c d f a
cgdac	 c g d a c
hicgacea	 h i c g a c e a
egbdiegb	 e g b d i e g b
ijejhafgi	 i j e j h a f g i
geiicf	 g e i i c f
ejad	 e j a d
eahfjdgij	 e a h f j d g i j
acbe	 a c b e
afhhdb	 a f h h d b
cjhdfejhb	 c j h d f e j h b
jaigc	 j a i g c
figjhb	 f i g j h b
gea	 g e a
adgifdef	 a d g i f d e f
fjfbie	 f j f b i e
hhe	 h h e
bja	 b j a
fifde	 f i f d e
hgeciii	 h g e c i i i
gcedg	 g c e d g
fjbhjc	 f j b h j c
ejdbdfgh	 e j d b d f g h
hdhcbdg	 h d h c b d g
eghb	 e g h b
gba	 g b a
fiadibgcd	 f i a d i b g c d
dcidddb	 d c i d d d b
jdfda	 j d f d a
fhcaejj	 f h c a e j j
hjbig	 h j b i g
ef	 e f
edjf	 e d j f
egja	 e g j a
eebiicb	 e e b i i c b
igigd	 i g i g d
dcedcj	 d c e d c j
iee	 i e e
dejahd	 d e j a h d
efi	 e f i
fba	 f b a
ad	 a d
jgaceb	 j g a c e b
ic	 i c
dfgj	 d f g j
bdafge	 b d a f g e
edbdhjdea	 e d b d h j d e a
idggaagfh	 i d g g a a g f h
cjcj	 c j c j
fifh	 f i f h
bhbfcbhff	 b h b f c b h f f
djbdagei	 d j b d a g e i
aeee	 a e e e
cg	 c g
fdgci	 f d g c i
gcdge	 g c d g e
faificj	 f a i f i c j
jhciffbbc	 j h c i f f b b c
jfh	 j f h
jejjdcaef	 j e j j d c a e f
aaaabje	 a a a a b j e
ajibjd	 a j i b j d
dd	 d d
gadifd	 g a d i f d
igbabjbeg	 i g b a b j b e g
fjdaagbee	 f j d a a g b e e
gec	 g e c
bad	 b a d
jcegb	 j c e g b
ddhdbde	 d d h d b d e
ccgf	 c c g f
jj	 j j
bhibdf	 b h i b d f
ijcc	 i j c c
aaeeie	 a a e e i e
hhejif	 h h e j i f
bfgha	 b f g h a
da	 d a
bfcfdiiih	 b f c f d i i i h
ceffbaae	 c e f f b a a e
ihdbhgc	 i h d b h g c
ah	 a h
hcbd	 h c b d
geadai	 g e a d a i
jfcf	 j f c f
dhfaddda	 d h f a d d d a
eifaihiba	 e i f a i h i b a
bbidf	 b b i d f
ceabbcgf	 c e a b b c g f
dhfagcee	 d h f a g c e e
gcifdi	 g c i f d i
iaf	 i a f
bifddbffc	 b i f d d b f f c
gabii	 g a b i i
ghc	 g h c
efjgfj	 e f j g f j
gajdejjei	 g a j d e j j e i
jffbjeih	 j f f b j e i h
gbbeh	 g b b e h
he	 h e
eea	 e e a
hcagjbada	 h c a g j b a d a
jaec	 j a e c
ifhjbfeh	 i f h j b f e h
hdbch	 h d b c h
hhcgdadh	 h h c g d a d h
ihggacidi	 i h g g a c i d i
difbc	 d i f b c
cgfgie	 c g f g i e
fcd	 f c d
ieg	 i e g
bgaeace	 b g a e a c e
bjhgaie	 b j h g a i e
hdijfg	 h d i j f g
djjfihfbi	 d j j f i h f b i
jcdjec	 j c d j e c
bejfdhg	 b e j f d h g
eddd	 e d d d
cdhaa	 c d h a a
bbjdh	 b b j d h
ch	 c h
djdfffig	 d j d f f f i g
agjhafhef	 a g j h a f h e f
jdgfcdifj	 j d g f c d i f j
fachfij	 f a c h f i j
cbea	 c b e a
ffe	 f f e
diacdddjf	 d i a c d d d j f
iachbjg	 i a c h b j g
cejeaccge	 c e j e a c c g e
aaf	 a a f
aiffchg	 a i f f c h g
bjc	 b j c
giahgd	 g i a h g d
jh	 j h
iejibg	 i e j i b g
jaaddceb	 j a a d d c e b
bbdcgj	 b b d c g j
cgf	 c g f
ehjhaec	 e h j h a e c
fbhhjid	 f b h h j i d
ghcdec	 g h c d e c
cae	 c a e
dhgaca	 d h g a c a
bj	 b j
ic	 i c
dgicifabb	 d g i c i f a b b
jhe	 j h e
jefcag	 j e f c a g
gdjbcgbd	 g d j b c g b d
igijhf	 i g i j h f
bbdjjdfe	 b b d j j d f e
acccff	 a c c c f f
cga	 c g a
bcdjc	 b c d j c
ah	 a h
gdfafaabh	 g d f a f a a b h
bdi	 b d i
eiadbaa	 e i a d b a a
iiei	 i i e i
fc	 f c
aaf	 a a f
ief	 i e f
ggah	 g g a h
gfhgdgbb	 g f h g d g b b
hhijegg	 h h i j e g g
iecj	 i e c j
hdhfdbffi	 h d h f d b f f i
gfidhej	 g f i d h e j
jiiba	 j i i b a
ca	 c a
jchbbe	 j c h b b e
ba	 b a
gecc	 g e c c
jcdicge	 j c d i c g e
ai	 a i
gjcjjij	 g j c j j i j
ffei	 f f e i
jdd	 j d d
abf	 a b f
caeac	 c a e a c
fc	 f c
ajifda	 a j i f d a
ffahgfcg	 f f a h g f c g
giijbibf	 g i i j b i b f
hecdgdc	 h e c d g d c
jcjigjaca	 j c j i g j a c a
afddf	 a f d d f
bggbjiagi	 b g g b j i a g i
edgje	 e d g j e
fe	 f e
baeba	 b a e b a
dggjdag	 d g g j d a g
cfi	 c f i
gjebg	 g j e b g
jddc	 j d d c
acjegcig	 a c j e g c i g
bd	 b d
ijg	 i j g
bbchfed	 b b c h f e d
cg	 c g
bjbbeagf	 b j b b e a g f
defhhceg	 d e f h h c e g
icied	 i c i e d
aie	 a i e
jdfhbbi	 j d f h b b i
digec	 d i g e c
geedhii	 g e e d h i i
ciij	 c i i j
ifcbgbj	 i f c b g b j
fjhj	 f j h j
edghg	 e d g h g
jgca	 j g c a
cddaajdb	 c d d a a j d b
fcgj	 f c g j
haeg	 h a e g
df	 d f
ajice	 a j i c e
eaehjhejg	 e a e h j h e j g
efd	 e f d
hfeigd	 h f e i g d
hbejfgahe	 h b e j f g a h e
dj	 d j
iabdeia	 i a b d e i a
gjfefhe	 g j f e f h e
if	 i f
edfehc	 e d f e h c
jdha	 j d h a
gjhjgfbd	 g j h j g f b d
dhjdghie	 d h j d g h i e
dffbgdde	 d f f b g d d e
gdfeeg	 g d f e e g
gf	 g f
cdiifjgj	 c d i i f j g j
heajdb	 h e a j d b
ajha	 a j h a
cbfi	 c b f i
ggdj	 g g d j
fdgiia	 f d g i i a
jigcbii	 j i g c b i i
eiheijji	 e i h e i j j i
jhhaghe	 j h h a g h e
fggacgh	 f g g a c g h
dcdfeifdc	 d c d f e i f d c
caicaidee	 c a i c a i d e e
dffagigd	 d f f a g i g d
ceacd	 c e a c d
cdgg	 c d g g
aaffeadh	 a a f f e a d h
acfcjf	 a c f c j f
adcaaice	 a d c a a i c e
iagcahgif	 i a g c a h g i f
jaffgd	 j a f f g d
icabfci	 i c a b f c i
bfbdhfedg	 b f b d h f e d g
aijjgd	 a i j j g d
hfigdgbc	 h f i g d g b c
hiebic	 h i e b i c
jad	 j a d
fbchaajje	 f b c h a a j j e
adicj	 a d i c j
bbjidc	 b b j i d c
idajejhcg	 i d a j e j h c g
aaich	 a a i c h
haaj	 h a a j
chh	 c h h
hecbggbfh	 h e c b g g b f h
cgcei	 c g c e i
afh	 a f h
bdhb	 b d h b
fbeehdfag	 f b e e h d f a g
ei	 e i
fh	 f h
bic	 b i c
acicbecd	 a c i c b e c d
hff	 h f f
dfc	 d f c
ibf	 i b f
acg	 a c g
aej	 a e j
bgcg	 b g c g
ijigfaib	 i j i g f a i b
dadbff	 d a d b f f
hji	 h j i
bceeiihhb	 b c e e i i h h b
cijcdh	 c i j c d h
jajcde	 j a j c d e
ag	 a g
hfecbd	 h f e c b d
ehj	 e h j
gdihcbc	 g d i h c b c
dcfj	 d c f j
eeidjgchb	 e e i d j g c h b
aaadddghb	 a a a d d d g h b
aabbeichf	 a a b b e i c h f
heeajd	 h e e a j d
jjaiffaj	 j j a i f f a j
ejdffb	 e j d f f b
gejgfbcb	 g e j g f b c b
heibjee	 h e i b j e e
ffjjecgid	 f f j j e c g i d
ccjg	 c c j g
dafd	 d a f d
ieaidh	 i e a i d h
bjhfbcgbj	 b j h f b c g b j
jci	 j c i
afdjdfgai	 a f d j d f g a i
aigii	 a i g i i
chdbic	 c h d b i c
ggih	 g g i h
hhgc	 h h g c
gcffhijji	 g c f f h i j j i
djdda	 d j d d a
hf	 h f
edcfje	 e d c f j e
gabi	 g a b i
hebc	 h e b c
bgdeec	 b g d e e c
ibeb	 i b e b
fhidc	 f h i d c
aidh	 a i d h
fgedjceg	 f g e d j c e g
hge	 h g e
begce	 b e g c e
abdfhjd	 a b d f h j d
cehaacbeg	 c e h a a c b e g
ihji	 i h j i
dejieghgd	 d e j i e g h g d
db	 d b
bjae	 b j a e
bih	 b i h
bidgjji	 b i d g j j i
hcbcbhcb	 h c b c b h c b
igi	 i g i
ibgjadef	 i b g j a d e f
gffe	 g f f e
dhc	 d h c
djcaiea	 d j c a i e a
hajjc	 h a j j c
ii	 i i
caehagi	 c a e h a g i
bggehea	 b g g e h e a
gbeigdd	 g b e i g d d
ccchhfc	 c c c h h f c
aa	 a a
dabaa	 d a b a a
gcd	 g c d
dgcj	 d g c j
ecjhd	 e c j h d
fgcef	 f g c e f
hch	 h c h
dahh	 d a h h
bbi	 b b i
cd	 c d
hba	 h b a
hcgg	 h c g g
fabhehbb	 f a b h e h b b
de	 d e
egdaab	 e g d a a b
fcjgc	 f c j g c
bj	 b j
hhhbdcjah	 h h h b d c j a h
ig	 i g
gd	 g d
iefddce	 i e f d d c e
iefheaea	 i e f h e a e a
figf	 f i g f
fdb	 f d b
fbdaihdj	 f b d a i h d j
hfjbjcji	 h f j b j c j i
hghfge	 h g h f g e
icafgjia	 i c a f g j i a
dfjgbad	 d f j g b a d
dcbd	 d c b d
gbb	 g b b
hgbi	 h g b i
bjdjjh	 b j d j j h
hebeiffj	 h e b e i f f j
eidib	 e i d i b
efgjfdida	 e f g j f d i d a
cde	 c d e
df	 d f
idfhgbe	 i d f h g b e
gfca	 g f c a
hifcgieje	 h i f c g i e j e
bbdbhgda	 b b d b h g d a
dcfha	 d c f h a
jbafah	 j b a f a h
cb	 c b
heejeaddb	 h e e j e a d d b
jciii	 j c i i i
cii	 c i i
icghc	 i c g h c
bgda	 b g d a
gjfab	 g j f a b
gaiehe	 g a i e h e
ihahjiebj	 i h a h j i e b j
geeefbeb	 g e e e f b e b
adbbh	 a d b b h
aba	 a b a
jie	 j i e
jhcjdb	 j h c j d b
bfaecgf	 b f a e c g f
ade	 a d e
cacdd	 c a c d d
bbdbcjjg	 b b d b c j j g
cd	 c d
edcadie	 e d c a d i e
cgai	 c g a i
bfaidc	 b f a i d c
aacj	 a a c j
iaaijbca	 i a a i j b c a
fjajjbj	 f j a j j b j
ifjbg	 i f j b g
gegc	 g e g c
agdad	 a g d a d
jibdad	 j i b d a d
he	 h e
agcghg	 a g c g h g
ejih	 e j i h
hfgebcfc	 h f g e b c f c
agbhbgb	 a g b h b g b
faafbjhf	 f a a f b j h f
bhif	 b h i f
hdd	 h d d
cjbfagcfa	 c j b f a g c f a
ebdaeebhd	 e b d a e e b h d
gfabidgag	 g f a b i d g a g
deegb	 d e e g b
aj	 a j
jafbff	 j a f b f f
afeidighc	 a f e i d i g h c
ghhfbi	 g h h f b i
ae	 a e
gcdejdad	 g c d e j d a d
aebea	 a e b e a
bjachhf	 b j a c h h f
giahfb	 g i a h f b
dgjhj	 d g j h j
egai	 e g a i
gjdbjfbfe	 g j d b j f b f e
faeafih	 f a e a f i h
db	 d b
giejff	 g i e j f f
gicgeg	 g i c g e g
fgfgjb	 f g f g j b
ggabbaggf	 g g a b b a g g f
dgjhe	 d g j h e
ihbhci	 i h b h c i
eja	 e j a
fghhe	 f g h h e
highdgb	 h i g h d g b
dchchaga	 d c h c h a g a
idcj	 i d c j
fc	 f c
iaid	 i a i d
gaiajgch	 g a i a j g c h
dfd	 d f d
hcjcjgd	 h c j c j g d
ihhgdja	 i h h g d j a
biiaaffbh	 b i i a a f f b h
jjej	 j j e j
ihee	 i h e e
fi	 f i
hihaf	 h i h a f
hgaf	 h g a f
efafj	 e f a f j
ciacddheg	 c i a c d d h e g
jcdebc	 j c d e b c
gjcccceae	 g j c c c c e a e
hhedijeg	 h h e d i j e g
dgfaaeddi	 d g f a a e d d i
ee	 e e
icjjgief	 i c j j g i e f
bacjbfhii	 b a c j b f h i i
iighhj	 i i g h h j
bj	 b j
afaegifef	 a f a e g i f e f
dafifjdje	 d a f i f j d j e
jachcai	 j a c h c a i
bdged	 b d g e d
gcf	 g c f
fcfghb	 f c f g h b
fcahbeaj	 f c a h b e a j
ejcgbd	 e j c g b d
cich	 c i c h
jhf	 j h f
cc	 c c
cf	 c f
ich	 i c h
dgfbg	 d g f b g
djah	 d j a h
fcaja	 f c a j a
ibfj	 i b f j
dfg	 d f g
ga	 g a
bibe	 b i b e
ffbdgcd	 f f b d g c d
hhcai	 h h c a i
gjddhi	 g j d d h i
jjgjhif	 j j g j h i f
ihhidhj	 i h h i d h j
jejdee	 j e j d e e
ee	 e e
eej	 e e j
ijc	 i j c
agicaj	 a g i c a j
jdfbeheai	 j d f b e h e a i
dehac	 d e h a c
fagfhea	 f a g f h e a
edddiih	 e d d d i i h
fijf	 f i j f
hdjgbfc	 h d j g b f c
aj	 a j
iajd	 i a j d
bfcfgj	 b f c f g j
djcjciahc	 d j c j c i a h c
eibdbbc	 e i b d b b c
dhgi	 d h g i
ge	 g e
jd	 j d
bffgf	 b f f g f
jhgd	 j h g d
hjcicbgde	 h j c i c b g d e
cjgcgddjj	 c j g c g d d j j
fhjgbg	 f h j g b g
jghbe	 j g h b e
bac	 b a c
did	 d i d
fi	 f i
ebfg	 e b f g
jej	 j e j
ab	 a b
gdchccj	 g d c h c c j
hbhgjfg	 h b h g j f g
bjccebjjb	 b j c c e b j j b
hedffi	 h e d f f i
fdafce	 f d a f c e
efiagg	 e f i a g g
hiafci	 h i a f c i
fd	 f d
ffb	 f f b
fah	 f a h
hgjdebjeg	 h g j d e b j e g
bdade	 b d a d e
hagffjed	 h a g f f j e d
hdcbigig	 h d c b i g i g
bbchcj	 b b c h c j
gcdjcifa	 g c d j c i f a
agjdd	 a g j d d
edhbadji	 e d h b a d j i
gcehec	 g c e h e c
dfjaf	 d f j a f
id	 i d
dd	 d d
icbfabifj	 i c b f a b i f j
eg	 e g
chidjdee	 c h i d j d e e
dgihe	 d g i h e
hd	 h d
ajeife	 a j e i f e
gdhde	 g d h d e
iejefihb	 i e j e f i h b
dbciibi	 d b c i i b i
gjgjhh	 g j g j h h
cecfgah	 c e c f g a h
hedb	 h e d b
hdj	 h d j
af	 a f
gd	 g d
egcghedg	 e g c g h e d g
ibeia	 i b e i a
ghcdhbbhb	 g h c d h b b h b
cfg	 c f g
hbfbib	 h b f b i b
bfhbgbhj	 b f h b g b h j
fgbcch	 f g b c c h
fdhhhgj	 f d h h h g j
fjabcah	 f j a b c a h
edeefie	 e d e e f i e
dgea	 d g e a
echg	 e c h g
gj	 g j
jhecbihca	 j h e c b i h c a
fecj	 f e c j
hjjbffjfc	 h j j b f f j f c
jjcejehe	 j j c e j e h e
gcdci	 g c d c i
iffa	 i f f a
ihjd	 i h j d
bh	 b h
chdjccjdb	 c h d j c c j d b
cacdhh	 c a c d h h
ehbhcgjd	 e h b h c g j d
fhbjbi	 f h b j b i
jcgg	 j c g g
ei	 e i
cgeebbab	 c g e e b b a b
hcdac	 h c d a c
ece	 e c e
cfiadifd	 c f i a d i f d
aeadc	 a e a d c
heahc	 h e a h c
afed	 a f e d
ie	 i e
gbhaifdhd	 g b h a i f d h d
ifeg	 i f e g
gggbdee	 g g g b d e e
djh	 d j h
eicihbci	 e i c i h b c i
acffeig	 a c f f e i g
haigjj	 h a i g j j
gc	 g c
fhba	 f h b a
fdicfi	 f d i c f i
hfacja	 h f a c j a
edg	 e d g
ibgd	 i b g d
chcbaa	 c h c b a a
ibjdeihad	 i b j d e i h a d
hgdcii	 h g d c i i
gibgjc	 g i b g j c
ae	 a e
jgbch	 j g b c h
bcde	 b c d e
aab	 a a b
icacgdi	 i c a c g d i
bca	 b c a
bafgej	 b a f g e j
fd	 f d
dbbafe	 d b b a f e
gj	 g j
aahg	 a a h g
fadjdgb	 f a d j d g b
jjgfjjf	 j j g f j j f
jfffijg	 j f f f i j g
dbafh	 d b a f h
fiadgdgid	 f i a d g d g i d
cj	 c j
df	 d f
heagbcff	 h e a g b c f f
gicgi	 g i c g i
jgji	 j g j i
egbhec	 e g b h e c
jcjcbb	 j c j c b b
ibcieb	 i b c i e b
egce	 e g c e
ajbgcf	 a j b g c f
hjf	 h j f
cjb	 c j b
hei	 h e i
fbij	 f b i j
hhef	 h h e f
hcjahfai	 h c j a h f a i
jihiagc	 j i h i a g c
ahjghi	 a h j g h i
hdi	 h d i
cd	 c d
gcabhbdeg	 g c a b h b d e g
cbhj	 c b h j
bfadgg	 b f a d g g
cbc	 c b c
adcd	 a d c d
cc	 c c
bhcec	 b h c e c
edia	 e d i a
jajhcgb	 j a j h c g b
hdhbchhc	 h d h b c h h c
ffjdhcgc	 f f j d h c g c
ehbh	 e h b h
edjdag	 e d j d a g
fdd	 f d d
dfjahi	 d f j a h i
ijfaie	 i j f a i e
caaiifbg	 c a a i i f b g
dejcad	 d e j c a d
jcaf	 j c a f
eadhj	 e a d h j
ea	 e a
dad	 d a d
ichh	 i c h h
jhbd	 j h b d
jijed	 j i j e d
ghedbhdh	 g h e d b h d h
fgbe	 f g b e
dfefcg	 d f e f c g
ddibcj	 d d i b c j
ajd	 a j d
gf	 g f
aiifdei	 a i i f d e i
adjf	 a d j f
ehbc	 e h b c
cce	 c c e
eaghjja	 e a g h j j a
edfjg	 e d f j g
fgdcg	 f g d c g
baac	 b a a c
faechjf	 f a e c h j f
dh	 d h
bejecf	 b e j e c f
afcebhgj	 a f c e b h g j
gbjeeijc	 g b j e e i j c
ajehcbig	 a j e h c b i g
fj	 f j
ifaggdcbe	 i f a g g d c b e
gcfai	 g c f a i
jfi	 j f i
jajhiibhj	 j a j h i i b h j
chj	 c h j
abihhd	 a b i h h d
jgjhbcgh	 j g j h b c g h
cafhjha	 c a f h j h a
achfijjdf	 a c h f i j j d f
bhaggdaf	 b h a g g d a f
eabgei	 e a b g e i
bfagd	 b f a g d
fjhc	 f j h c
egcfjfjdi	 e g c f j f j d i
idddfjb	 i d d d f j b
ghi	 g h i
ggieefh	 g g i e e f h
bgfcbc	 b g f c b c
jfefh	 j f e f h
jc	 j c
gfhcg	 g f h c g
cgffgf	 c g f f g f
hh	 h h
gddcaiib	 g d d c a i i b
efcih	 e f c i h
fbhf	 f b h f
edde	 e d d e
jbha	 j b h a
faceebgef	 f a c e e b g e f
ccf	 c c f
bhj	 b h j
fabcjige	 f a b c j i g e
bafgcg	 b a f g c g
dgide	 d g i d e
heghifhcj	 h e g h i f h c j
dbjijaj	 d b j i j a j
cfic	 c f i c
cfeac	 c f e a c
fibee	 f i b e e
ifdibceci	 i f d i b c e c i
ch	 c h
ahcbdj	 a h c b d j
hebgggid	 h e b g g g i d
ccacab	 c c a c a b
agdd	 a g d d
jcfaf	 j c f a f
dcb	 d c b
fiagjaa	 f i a g j a a
gggae	 g g g a e
geegabf	 g e e g a b f
efcbedh	 e f c b e d h
cdghee	 c d g h e e
jae	 j a e
cd	 c d
jfcg	 j f c g
aejigagg	 a e j i g a g g
abb	 a b b
hbafe	 h b a f e
ied	 i e d
cajfghh	 c a j f g h h
ebgjb	 e b g j b
djfidggba	 d j f i d g g b a
fdfgahi	 f d f g a h i
ch	 c h
fcgfbj	 f c g f b j
eh	 e h
bdciahehc	 b d c i a h e h c
febhdag	 f e b h d a g
djdhjiac	 d j d h j i a c
jgbgh	 j g b g h
iahejcgc	 i a h e j c g c
baai	 b a a i
ij	 i j
ab	 a b
hbfiijcdc	 h b f i i j c d c
afec	 a f e c
ijefih	 i j e f i h
ji	 j i
edfd	 e d f d
ggeaafb	 g g e a a f b
heaf	 h e a f
ifbgbcfhj	 i f b g b c f h j
eaghjhic	 e a g h j h i c
fj	 f j
ajhed	 a j h e d
ciji	 c i j i
ehfcb	 e h f c b
jidcdjdfb	 j i d c d j d f b
hhchcgb	 h h c h c g b
egiagiicf	 e g i a g i i c f
jggj	 j g g j
iebbgj	 i e b b g j
ajhbegcdh	 a j h b e g c d h
gjhcacii	 g j h c a c i i
icgicbehd	 i c g i c b e h d
giff	 g i f f
aeec	 a e e c
ghadabhf	 g h a d a b h f
bjgfcae	 b j g f c a e
gc	 g c
gbdedibhb	 g b d e d i b h b
bghcif	 b g h c i f
hbdjbi	 h b d j b i
be	 b e
aibga	 a i b g a
jb	 j b
beidhf	 b e i d h f
fc	 f c
gdaia	 g d a i a
cbgd	 c b g d
gc	 g c
ijajghg	 i j a j g h g
djdg	 d j d g
iejiechd	 i e j i e c h d
jchbh	 j c h b h
aaacaa	 a a a c a a
bfaefjjbe	 b f a e f j j b e
jihbghief	 j i h b g h i e f
gbjdhccdi	 g b j d h c c d i
cahieab	 c a h i e a b
bff	 b f f
iibifbgi	 i i b i f b g i
bbdaidag	 b b d a i d a g
gfiah	 g f i a h
ijjhjjbd	 i j j h j j b d
df	 d f
hc	 h c
cdbeajcc	 c d b e a j c c
dgefe	 d g e f e
bicb	 b i c b
gbdgeaa	 g b d g e a a
ehacedef	 e h a c e d e f
ghfdej	 g h f d e j
jjhdcj	 j j h d c j
egcdfbiha	 e g c d f b i h a
ef	 e f
jgcca	 j g c c a
ida	 i d a
jceh	 j c e h
chchdjb	 c h c h d j b
gd	 g d
dbhg	 d b h g
ifdei	 i f d e i
eji	 e j i
jgbc	 j g b c
eafjjc	 e a f j j c
ha	 h a
jfeiiij	 j f e i i i j
cahidbaa	 c a h i d b a a
fecfgh	 f e c f g h
jdi	 j d i
ehehjabe	 e h e h j a b e
jfafhc	 j f a f h c
df	 d f
gijcbch	 g i j c b c h
fiihfh	 f i i h f h
aeddci	 a e d d c i
eedbgcahb	 e e d b g c a h b
cdccc	 c d c c c
bfgdgbe	 b f g d g b e
bj	 b j
djiddbgjh	 d j i d d b g j h
bbbih	 b b b i h
jfajj	 j f a j j
eifiiadgc	 e i f i i a d g c
ej	 e j
eihdcbej	 e i h d c b e j
bdgh	 b d g h
gd	 g d
jce	 j c e
diehdc	 d i e h d c
cfjbadba	 c f j b a d b a
djjh	 d j j h
ajehcej	 a j e h c e j
cgfcb	 c g f c b
jdaf	 j d a f
gdcebdd	 g d c e b d d
fgdfgbcfh	 f g d f g b c f h
hhgahhebe	 h h g a h h e b e
jdagdi	 j d a g d i
ecjgcjhjc	 e c j g c j h j c
eebhc	 e e b h c
eaegdidf	 e a e g d i d f
ac	 a c
aihgaai	 a i h g a a i
fabffa	 f a b f f a
cafhd	 c a f h d
cg	 c g
haejda	 h a e j d a
abeidedjg	 a b e i d e d j g
jehghei	 j e h g h e i
fcgdd	 f c g d d
eheaig	 e h e a i g
cicbhfbg	 c i c b h f b g
bbhbegih	 b b h b e g i h
fjggjhagb	 f j g g j h a g b
ighfei	 i g h f e i
jbgec	 j b g e c
jgcbfccdg	 j g c b f c c d g
cgdg	 c g d g
hegebbfga	 h e g e b b f g a
dbcibhc	 d b c i b h c
cja	 c j a
jj	 j j
achf	 a c h f
bajcehc	 b a j c e h c
dbdfe	 d b d f e
cefdbbh	 c e f d b b h
cjjfahjgd	 c j j f a h j g d
hehh	 h e h h
icbba	 i c b b a
cabgca	 c a b g c a
ajeb	 a j e b
geiad	 g e i a d
hhbgjd	 h h b g j d
hdfd	 h d f d
dhedec	 d h e d e c
ea	 e a
fecgfggfh	 f e c g f g g f h
gjgeih	 g j g e i h
aegbcde	 a e g b c d e
hfceef	 h f c e e f
gg	 g g
chjfjecdd	 c h j f j e c d d
fahieda	 f a h i e d a
hbg	 h b g
hcejchjae	 h c e j c h j a e
cgjjbfgec	 c g j j b f g e c
hfb	 h f b
de	 d e
fiba	 f i b a
hccdfhbj	 h c c d f h b j
jhdgf	 j h d g f
bijhi	 b i j h i
gc	 g c
ibj	 i b j
feifdc	 f e i f d c
chd	 c h d
aj	 a j
cbig	 c b i g
cecc	 c e c c
cce	 c c e
bchfcedb	 b c h f c e d b
ajfcb	 a j f c b
ijhf	 i j h f
defijg	 d e f i j g
deg	 d e g
gbjaajbf	 g b j a a j b f
dga	 d g a
if	 i f
dge	 d g e
ejeigadad	 e j e i g a d a d
bjjhhcfga	 b j j h h c f g a
jhe	 j h e
adgeg	 a d g e g
hicifhdc	 h i c i f h d c
gbhbbf	 g b h b b f
be	 b e
gjidbgfb	 g j i d b g f b
fjhgihd	 f j h g i h d
hae	 h a e
icdijdgjg	 i c d i j d g j g
dgfebgj	 d g f e b g j
jcicij	 j c i c i j
biagefi	 b i a g e f i
gfg	 g f g
ddajj	 d d a j j
gghfdcgfg	 g g h f d c g f g
cge	 c g e
gajgea	 g a j g e a
ehagci	 e h a g c i
idfgje	 i d f g j e
beagabci	 b e a g a b c i
jgidbcibe	 j g i d b c i b e
eebg	 e e b g
fe	 f e
egebbgjb	 e g e b b g j b
gh	 g h
abdf	 a b d f
jhgdd	 j h g d d
dacci	 d a c c i
da	 d a
hjh	 h j h
jfa	 j f a
chbaa	 c h b a a
bcf	 b c f
gafghdd	 g a f g h d d
gddai	 g d d a i
bjag	 b j a g
adicd	 a d i c d
gefehcdc	 g e f e h c d c
idfb	 i d f b
hi	 h i
agbd	 a g b d
hhh	 h h h
adhd	 a d h d
ii	 i i
ggjh	 g g j h
cjjfh	 c j j f h
jijhg	 j i j h g
fjhdc	 f j h d c
jhd	 j h d
ig	 i g
dehafa	 d e h a f a
hiiiabi	 h i i i a b i
dcgjhddad	 d c g j h d d a d
jbgfecfj	 j b g f e c f j
ifcbeiig	 i f c b e i i g
egd	 e g d
hdie	 h d i e
ihcdi	 i h c d i
jccggfeee	 j c c g g f e e e
hegcaibj	 h e g c a i b j
aiidbhfc	 a i i d b h f c
fhg	 f h g
ieja	 i e j a
iccbbj	 i c c b b j
icac	 i c a c
fg	 f g
iabdecb	 i a b d e c b
ebhjfeec	 e b h j f e e c
dh	 d h
jcajjaej	 j c a j j a e j
djdjhb	 d j d j h b
hijffheja	 h i j f f h e j a
aehag	 a e h a g
baa	 b a a
deeeciei	 d e e e c i e i
aad	 a a d
gbfbjhigi	 g b f b j h i g i
ecdcjgjh	 e c d c j g j h
cjeejhbhj	 c j e e j h b h j
jgeiabd	 j g e i a b d
ehhfhiji	 e h h f h i j i
ie	 i e
jfid	 j f i d
hffajfj	 h f f a j f j
ehai	 e h a i
jge	 j g e
ac	 a c
ffadje	 f f a d j e
hcghjg	 h c g h j g
bjbeg	 b j b e g
aifgd	 a i f g d
igjbcd	 i g j b c d
ceji	 c e j i
cbagij	 c b a g i j
hfgh	 h f g h
hjed	 h j e d
iebd	 i e b d
febcfdi	 f e b c f d i
bjadaa	 b j a d a a
biiehjh	 b i i e h j h
jigbic	 j i g b i c
gbjf	 g b j f
ifjg	 i f j g
gi	 g i
ij	 i j
gedj	 g e d j
hca	 h c a
ajcgicd	 a j c g i c d
gedacd	 g e d a c d
idhcaejgg	 i d h c a e j g g
aficbeied	 a f i c b e i e d
gdjgbchee	 g d j g b c h e e
dgbjeghd	 d g b j e g h d
jicjbgha	 j i c j b g h a
jdjhjhg	 j d j h j h g
ajffejaj	 a j f f e j a j
ddacjfb	 d d a c j f b
cdjiejeh	 c d j i e j e h
gdebdeh	 g d e b d e h
fch	 f c h
bcgejifb	 b c g e j i f b
aeicjfb	 a e i c j f b
dfhehcjhf	 d f h e h c j h f
dbdbhaeff	 d b d b h a e f f
dchaje	 d c h a j e
bjicab	 b j i c a b
dabjge	 d a b j g e
hfdidi	 h f d i d i
dadeaf	 d a d e a f
af	 a f
efacbie	 e f a c b i e
bi	 b i
ie	 i e
bdbad	 b d b a d
ibihfbgah	 i b i h f b g a h
iibafb	 i i b a f b
ci	 c i
jh	 j h
hhhfdad	 h h h f d a d
ga	 g a
eeiaadfa	 e e i a a d f a
gcffc	 g c f f c
jeheagada	 j e h e a g a d a
jbhha	 j b h h a
afbgbbbje	 a f b g b b b j e
dga	 d g a
heebh	 h e e b h
efdf	 e f d f
bhghijaeg	 b h g h i j a e g
abbch	 a b b c h
chgfgcc	 c h g f g c c
dgeidh	 d g e i d h
iiejhda	 i i e j h d a
cghjh	 c g h j h
iaff	 i a f f
gaghge	 g a g h g e
dbh	 d b h
hbijdcgaf	 h b i j d c g a f
cggbdjha	 c g g b d j h a
jhh	 j h h
adcbi	 a d c b i
dhdiigag	 d h d i i g a g
ajeeahj	 a j e e a h j
jeeb	 j e e b
ijhafcgi	 i j h a f c g i
baejgcfd	 b a e j g c f d
eejee	 e e j e e
efdjdgfb	 e f d j d g f b
jhfgha	 j h f g h a
dhe	 d h e
jhjh	 j h j h
ecda	 e c d a
dgdci	 d g d c i
ejbagbigc	 e j b a g b i g c
ehjicf	 e h j i c f
ja	 j a
fchcbaf	 f c h c b a f
badcjbjdc	 b a d c j b j d c
jeifhdi	 j e i f h d i
hdffhbh	 h d f f h b h
hffbbged	 h f f b b g e d
gciedijef	 g c i e d i j e f
cajccag	 c a j c c a g
jfh	 j f h
hfcbdad	 h f c b d a d
fgib	 f g i b
adi	 a d i
aceje	 a c e j e
jgbggbfhh	 j g b g g b f h h
bijhf	 b i j h f
bihbefb	 b i h b e f b
jjbgaefg	 j j b g a e f g
hceihahcb	 h c e i h a h c b
abjgd	 a b j g d
iaedcfe	 i a e d c f e
bbejchibh	 b b e j c h i b h
djdehcd	 d j d e h c d
hebef	 h e b e f
hhbf	 h h b f
cahababdc	 c a h a b a b d c
efcigihha	 e f c i g i h h a
hcehb	 h c e h b
cfdjbjae	 c f d j b j a e
dac	 d a c
egid	 e g i d
fca	 f c a
bhiegfbf	 b h i e g f b f
bc	 b c
gac	 g a c
ehjecbfd	 e h j e c b f d
ebhgbbcee	 e b h g b b c e e
edbjdf	 e d b j d f
gjcdgi	 g j c d g i
afh	 a f h
jja	 j j a
abcdegj	 a b c d e g j
jf	 j f
hbgddcb	 h b g d d c b
gjif	 g j i f
hifcc	 h i f c c
jbi	 j b i
gh	 g h
jbdfbgc	 j b d f b g c
ageggd	 a g e g g d
bfhbcjh	 b f h b c j h
chc	 c h c
hcfajdfdg	 h c f a j d f d g
ac	 a c
aahga	 a a h g a
bbjcbaa	 b b j c b a a
gbceca	 g b c e c a
cjedeajf	 c j e d e a j f
efa	 e f a
ageeag	 a g e e a g
feiaej	 f e i a e j
ieic	 i e i c
febebj	 f e b e b j
gfcega	 g f c e g a
di	 d i
gdejacafe	 g d e j a c a f e
acei	 a c e i
jdh	 j d h
hhijc	 h h i j c
cafbbj	 c a f b b j
hfbgdaea	 h f b g d a e a
id	 i d
ii	 i i
djaaagib	 d j a a a g i b
gf	 g f
ffjegbe	 f f j e g b e
dh	 d h
fadhihcaf	 f a d h i h c a f
ibgfc	 i b g f c
aidbaie	 a i d b a i e
hbacedi	 h b a c e d i
chggfj	 c h g g f j
bfdb	 b f d b
ecghdbhhb	 e c g h d b h h b
jaafcibaf	 j a a f c i b a f
fd	 f d
fjc	 f j c
cef	 c e f
afcegci	 a f c e g c i
iibgaec	 i i b g a e c
jdhifffc	 j d h i f f f c
jijebe	 j i j e b e
iihb	 i i h b
cfjgg	 c f j g g
hffj	 h f f j
hib	 h i b
iig	 i i g
fae	 f a e
iffe	 i f f e
jhaadij	 j h a a d i j
ig	 i g
cjhabac	 c j h a b a c
bicagh	 b i c a g h
fic	 f i c
ehifd	 e h i f d
daajcc	 d a a j c c
dd	 d d
jjdc	 j j d c
ciehbe	 c i e h b e
iafbibbce	 i a f b i b b c e
idiffgd	 i d i f f g d
eaejdh	 e a e j d h
aaecgaag	 a a e c g a a g
behjf	 b e h j f
hgd	 h g d
bg	 b g
bjhebd	 b j h e b d
igc	 i g c
ihdafe	 i h d a f e
eafedic	 e a f e d i c
jffeae	 j f f e a e
fh	 f h
efehhdd	 e f e h h d d
fahffh	 f a h f f h
gedfjj	 g e d f j j
egebcg	 e g e b c g
hjd	 h j d
ediidhfhd	 e d i i d h f h d
daeaba	 d a e a b a
daihdhade	 d a i h d h a d e
dfbfighd	 d f b f i g h d
hgb	 h g b
bccajabe	 b c c a j a b e
fjigifie	 f j i g i f i e
fhhai	 f h h a i
id	 i d
jehfj	 j e h f j
hhfcgfe	 h h f c g f e
eac	 e a c
dbieedaa	 d b i e e d a a
hdfbdga	 h d f b d g a
ffgfbbia	 f f g f b b i a
deh	 d e h
cbdiaf	 c b d i a f
aebai	 a e b a i
giefdf	 g i e f d f
hcbcai	 h c b c a i
ce	 c e
ceaghc	 c e a g h c
bcfbbaecd	 b c f b b a e c d
ehjee	 e h j e e
diiaa	 d i i a a
fij	 f i j
fgdgj	 f g d g j
adhijgc	 a d h i j g c
fdgdhj	 f d g d h j
dhdj	 d h d j
hbcbhgbie	 h b c b h g b i e
hdhihjji	 h d h i h j j i
ba	 b a
ahid	 a h i d
hbe	 h b e
ddgbdade	 d d g b d a d e
jgeci	 j g e c i
fcceb	 f c c e b
ecbhagh	 e c b h a g h
ib	 i b
dghhge	 d g h h g e
gfaic	 g f a i c
fhbibfbih	 f h b i b f b i h
gffhbcbdg	 g f f h b c b d g
ihhebi	 i h h e b i
cdiia	 c d i i a
jghi	 j g h i
cgjhggbhg	 c g j h g g b h g
dfjg	 d f j g
eibjhhbg	 e i b j h h b g
cff	 c f f
ehacfchj	 e h a c f c h j
hi	 h i
gcae	 g c a e
cj	 c j
fdbgichi	 f d b g i c h i
adcj	 a d c j
cdg	 c d g
cadijgd	 c a d i j g d
bjgfad	 b j g f a d
dcjihba	 d c j i h b a
hh	 h h
hi	 h i
adi	 a d i
ddfciifi	 d d f c i i f i
bjfgffgi	 b j f g f f g i
jj	 j j
ccbdd	 c c b d d
jcdfhj	 j c d f h j
aci	 a c i
cjce	 c j c e
icifhgeb	 i c i f h g e b
afdgjdd	 a f d g j d d
fad	 f a d
bbbjcecge	 b b b j c e c g e
dcdafhfd	 d c d a f h f d
bbcbfc	 b b c b f c
ahieabg	 a h i e a b g
gcbjjdeh	 g c b j j d e h
ffeje	 f f e j e
bjeea	 b j e e a
bchah	 b c h a h
gehi	 g e h i
ehajh	 e h a j h
gciigid	 g c i i g i d
gjijfa	 g j i j f a
cbehhfj	 c b e h h f j
dbdc	 d b d c
dcfhabje	 d c f h a b j e
dbfgjc	 d b f g j c
hjfhf	 h j f h f
abihcdahd	 a b i h c d a h d
gaca	 g a c a
aada	 a a d a
djdd	 d j d d
iefjjij	 i e f j j i j
bchaje	 b c h a j e
jfe	 j f e
bjeicfdj	 b j e i c f d j
chchhhhca	 c h c h h h h c a
ejefbif	 e j e f b i f
bhjji	 b h j j i
bcadijd	 b c a d i j d
adjfdcb	 a d j f d c b
ba	 b a
dcjdjbb	 d c j d j b b
iaiae	 i a i a e
acecc	 a c e c c
fggjacc	 f g g j a c c
ce	 c e
bajiahei	 b a j i a h e i
aaj	 a a j
ehjeebgf	 e h j e e b g f
dccgg	 d c c g g
afjjgbhd	 a f j j g b h d
ajhaecfb	 a j h a e c f b
ci	 c i
hba	 h b a
eahbb	 e a h b b
ef	 e f
idhhjca	 i d h h j c a
ghebd	 g h e b d
hbjhehah	 h b j h e h a h
ecf	 e c f
hjhai	 h j h a i
hdf	 h d f
ghgdjeh	 g h g d j e h
idbic	 i d b i c
adj	 a d j
ggddh	 g g d d h
aj	 a j
fibahgaa	 f i b a h g a a
hdjie	 h d j i e
bd	 b d
cb	 c b
chgbihadd	 c h g b i h a d d
afghijhag	 a f g h i j h a g
ejfj	 e j f j
bbhh	 b b h h
ijh	 i j h
fecjdfcc	 f e c j d f c c
hj	 h j
heiag	 h e i a g
ihhh	 i h h h
bcibaej	 b c i b a e j
cfafjijc	 c f a f j i j c
hcb	 h c b
gfehca	 g f e h c a
bgjh	 b g j h
dag	 d a g
faahbhef	 f a a h b h e f
ebbf	 e b b f
hfd	 h f d
jhjbc	 j h j b c
fgcddbhi	 f g c d d b h i
cai	 c a i
jc	 j c
bhghchf	 b h g h c h f
ijeciac	 i j e c i a c
eaajee	 e a a j e e
ihigag	 i h i g a g
dd	 d d
ad	 a d
hdjei	 h d j e i
ghicjbee	 g h i c j b e e
ba	 b a
ii	 i i
gc	 g c
dh	 d h
egjfa	 e g j f a
djdg	 d j d g
hb	 h b
biifih	 b i i f i h
ga	 g a
ac	 a c
ecgceebb	 e c g c e e b b
bfgdg	 b f g d g
jceb	 j c e b
aheihgig	 a h e i h g i g
iibcchhf	 i i b c c h h f
acc	 a c c
iha	 i h a
jaecfbc	 j a e c f b c
bcjihefji	 b c j i h e f j i
dfdff	 d f d f f
ijdi	 i j d i
abjag	 a b j a g
cj	 c j
aegahic	 a e g a h i c
fej	 f e j
fha	 f h a
cgajjfgh	 c g a j j f g h
aicaf	 a i c a f
dcc	 d c c
hcia	 h c i a
cch	 c c h
fdbjiade	 f d b j i a d e
fbgaaahdd	 f b g a a a h d d
ccegf	 c c e g f
gga	 g g a
ajjif	 a j j i f
edfcj	 e d f c j
fjcaejd	 f j c a e j d
aifjcfi	 a i f j c f i
adaeg	 a d a e g
jbajga	 j b a j g a
jjidhdf	 j j i d h d f
icbejb	 i c b e j b
agbhji	 a g b h j i
bjc	 b j c
hhcbec	 h h c b e c
habijg	 h a b i j g
iagd	 i a g d
aah	 a a h
hgedbj	 h g e d b j
daghdga	 d a g h d g a
cibfdjhae	 c i b f d j h a e
fg	 f g
ijf	 i j f
egcfjidhg	 e g c f j i d h g
ijdajcgd	 i j d a j c g d
cedbgf	 c e d b g f
fghbfb	 f g h b f b
agjfae	 a g j f a e
jgfdfgi	 j g f d f g i
daejcg	 d a e j c g
haaigbjae	 h a a i g b j a e
dac	 d a c
bbhhj	 b b h h j
jgbf	 j g b f
gjh	 g j h
jbeije	 j b e i j e
iegff	 i e g f f
fjc	 f j c
fjjgi	 f j j g i
ggdfg	 g g d f g
adifhbhf	 a d i f h b h f
hhdi	 h h d i
gibcdbaj	 g i b c d b a j
gfbiijii	 g f b i i j i i
gaaadadhe	 g a a a d a d h e
haafff	 h a a f f f
ibbgi	 i b b g i
fbdeebij	 f b d e e b i j
jhd	 j h d
gjaffib	 g j a f f i b
dehb	 d e h b
bfdih	 b f d i h
cf	 c f
hggbh	 h g g b h
bjbd	 b j b d
ee	 e e
bebic	 b e b i c
fgca	 f g c a
bjabgeid	 b j a b g e i d
bgjgdha	 b g j g d h a
fb	 f b
dffifj	 d f f i f j
ejfcjfia	 e j f c j f i a
bhfehia	 b h f e h i a
afbdh	 a f b d h
gcaaj	 g c a a j
bjdjg	 b j d j g
bfgehcdid	 b f g e h c d i d
dih	 d i h
jfijcaj	 j f i j c a j
jgfdjc	 j g f d j c
hgad	 h g a d
bfjaccfi	 b f j a c c f i
jhcggci	 j h c g g c i
fjffgfhj	 f j f f g f h j
cgfi	 c g f i
cd	 c d
dbbhd	 d b b h d
if	 i f
edfgjij	 e d f g j i j
dj	 d j
jc	 j c
bejeidhib	 b e j e i d h i b
ggfccdaeb	 g g f c c d a e b
bdddibdi	 b d d d i b d i
hagiiec	 h a g i i e c
egd	 e g d
bbidigie	 b b i d i g i e
cgchda	 c g c h d a
fgh	 f g h
cjhgac	 c j h g a c
eaihac	 e a i h a c
ghd	 g h d
eddgh	 e d d g h
adcfad	 a d c f a d
hhhd	 h h h d
eaeecja	 e a e e c j a
dibiegid	 d i b i e g i d
jddd	 j d d d
hfbjd	 h f b j d
cbddeebe	 c b d d e e b e
cabhajfhc	 c a b h a j f h c
jchbhiagg	 j c h b h i a g g
gifgchiee	 g i f g c h i e e
dehifga	 d e h i f g a
cj	 c j
baabicgdg	 b a a b i c g d g
afgc	 a f g c
dahcf	 d a h c f
ebg	 e b g
becacei	 b e c a c e i
ebjehihaa	 e b j e h i h a a
igbhiea	 i g b h i e a
cacdhci	 c a c d h c i
ce	 c e
ggjbdgb	 g g j b d g b
eghdbg	 e g h d b g
dei	 d e i
chfhjb	 c h f h j b
iecaj	 i e c a j
hb	 h b
igei	 i g e i
bahbg	 b a h b g
agfi	 a g f i
eihg	 e i h g
hedc	 h e d c
cdc	 c d c
fhbdgdbha	 f h b d g d b h a
jegbgbjha	 j e g b g b j h a
iecej	 i e c e j
afbccjeig	 a f b c c j e i g
abad	 a b a d
iecbdcjf	 i e c b d c j f
cehie	 c e h i e
ii	 i i
gcdbcd	 g c d b c d
eaiefb	 e a i e f b
hhbdddf	 h h b d d d f
chacjh	 c h a c j h
cbaifjjj	 c b a i f j j j
jahcficf	 j a h c f i c f
hffieeieg	 h f f i e e i e g
ajdeaagaj	 a j d e a a g a j
gah	 g a h
diei	 d i e i
eghaia	 e g h a i a
ijagjidj	 i j a g j i d j
ab	 a b
egffcbh	 e g f f c b h
bdgjfd	 b d g j f d
bfhgfa	 b f h g f a
jicfc	 j i c f c
ecggig	 e c g g i g
jb	 j b
fefh	 f e f h
afec	 a f e c
ded	 d e d
dai	 d a i
dfhhdiif	 d f h h d i i f
jbcacdff	 j b c a c d f f
fgg	 f g g
bggeifbej	 b g g e i f b e j
acc	 a c c
chg	 c h g
hgciecgbg	 h g c i e c g b g
jbgdbgdf	 j b g d b g d f
ejjcgdg	 e j j c g d g
aibceihfa	 a i b c e i h f a
jbebg	 j b e b g
ffbhdeb	 f f b h d e b
iihjjebac	 i i h j j e b a c
bfjg	 b f j g
ecdjc	 e c d j c
hj	 h j
cd	 c d
ibiaaiehb	 i b i a a i e h b
dcdahj	 d c d a h j
fga	 f g a
gcbfcacgi	 g c b f c a c g i
ficcacdea	 f i c c a c d e a
dfehaa	 d f e h a a
bhd	 b h d
fbehbj	 f b e h b j
ajfafbcg	 a j f a f b c g
dba	 d b a
bajdac	 b a j d a c
ghbdbffc	 g h b d b f f c
gafjjg	 g a f j j g
fagjd	 f a g j d
iedhiebb	 i e d h i e b b
jagafdici	 j a g a f d i c i
bhj	 b h j
iifbjdee	 i i f b j d e e
hfiede	 h f i e d e
ecgadg	 e c g a d g
ieh	 i e h
haife	 h a i f e
gffdi	 g f f d i
igiebcgc	 i g i e b c g c
jfdb	 j f d b
dhcbhhf	 d h c b h h f
ecf	 e c f
chfjfecac	 c h f j f e c a c
fgcih	 f g c i h
faegce	 f a e g c e
jd	 j d
bcieihh	 b c i e i h h
fiji	 f i j i
ieggjgh	 i e g g j g h
hdbabdj	 h d b a b d j
fcdaabfc	 f c d a a b f c
hj	 h j
eeh	 e e h
gjjhie	 g j j h i e
hjjcghb	 h j j c g h b
jdhfb	 j d h f b
faajaah	 f a a j a a h
dagad	 d a g a d
bgbfad	 b g b f a d
bdcjbcfd	 b d c j b c f d
adgehggf	 a d g e h g g f
ffidbi	 f f i d b i
bajjbg	 b a j j b g
ihghbbgj	 i h g h b b g j
ehcdfaagf	 e h c d f a a g f
ebfjeebd	 e b f j e e b d
geahdfcj	 g e a h d f c j
ghebgjaef	 g h e b g j a e f
cgffhah	 c g f f h a h
bahcjiji	 b a h c j i j i
cfh	 c f h
cgefbgd	 c g e f b g d
hi	 h i
af	 a f
bah	 b a h
dacje	 d a c j e
baaadhejb	 b a a a d h e j b
fhhjeghhg	 f h h j e g h h g
gbaed	 g b a e d
hdj	 h d j
fhiadcg	 f h i a d c g
bg	 b g
fhhejdfdg	 f h h e j d f d g
egfdid	 e g f d i d
cea	 c e a
bd	 b d
ghjcggd	 g h j c g g d
cheeeg	 c h e e e g
hciic	 h c i i c
caabahff	 c a a b a h f f
dcihfegif	 d c i h f e g i f
aiagfih	 a i a g f i h
deidg	 d e i d g
cfabdgjg	 c f a b d g j g
ie	 i e
dggchabe	 d g g c h a b e
ddhejd	 d d h e j d
cgdbahgbi	 c g d b a h g b i
hdbhi	 h d b h i
ja	 j a
fgfgbc	 f g f g b c
gjhdcie	 g j h d c i e
gfgdha	 g f g d h a
ajhfddia	 a j h f d d i a
bdf	 b d f
ecafdaii	 e c a f d a i i
gdjjgafhj	 g d j j g a f h j
jbg	 j b g
dabbbdb	 d a b b b d b
dge	 d g e
ebghed	 e b g h e d
ec	 e c
ehacbab	 e h a c b a b
dehfi	 d e h f i
efj	 e f j
je	 j e
ahfh	 a h f h
igb	 i g b
deddea	 d e d d e a
debjha	 d e b j h a
jjfefdidd	 j j f e f d i d d
cg	 c g
iibj	 i i b j
ahhhejhhb	 a h h h e j h h b
icehcjcbd	 i c e h c j c b d
decihdfhf	 d e c i h d f h f
hfefi	 h f e f i
eecibibh	 e e c i b i b h
hbdedich	 h b d e d i c h
bgh	 b g h
ifjbbij	 i f j b b i j
iig	 i i g
hga	 h g a
icbhacfc	 i c b h a c f c
ej	 e j
iejbab	 i e j b a b
ehigeige	 e h i g e i g e
ijcjf	 i j c j f
hgd	 h g d
feab	 f e a b
eeg	 e e g
edcfiijgj	 e d c f i i j g j
jahcje	 j a h c j e
fbeagchb	 f b e a g c h b
eehb	 e e h b
eacfbee	 e a c f b e e
jdbhcai	 j d b h c a i
gbjagddc	 g b j a g d d c
ghcf	 g h c f
cddjdiab	 c d d j d i a b
cjcjbfdgj	 c j c j b f d g j
jdgddciae	 j d g d d c i a e
hafcf	 h a f c f
abffbfda	 a b f f b f d a
bejchgfh	 b e j c h g f h
aijb	 a i j b
ahhgbd	 a h h g b d
dbjbi	 d b j b i
bc	 b c
ebdaibbi	 e b d a i b b i
fdad	 f d a d
jg	 j g
igche	 i g c h e
ce	 c e
jdfffh	 j d f f f h
aiegh	 a i e g h
ffdiba	 f f d i b a
fab	 f a b
ehjhj	 e h j h j
ccidefjj	 c c i d e f j j
hegdg	 h e g d g
gcgijdidb	 g c g i j d i d b
ibgjch	 i b g j c h
agdeei	 a g d e e i
hhjehidg	 h h j e h i d g
bheeeggh	 b h e e e g g h
bhi	 b h i
jjeba	 j j e b a
fag	 f a g
hjcd	 h j c d
gbgfehchj	 g b g f e h c h j
fheaicdb	 f h e a i c d b
fahcibfi	 f a h c i b f i
cei	 c e i
cfc	 c f c
cccdgh	 c c c d g h
ii	 i i
bcdifi	 b c d i f i
ic	 i c
cjjjgh	 c j j j g h
cbjei	 c b j e i
diijidid	 d i i j i d i d
jaffga	 j a f f g a
cbiheb	 c b i h e b
bhdfc	 b h d f c
aeece	 a e e c e
ieghb	 i e g h b
hdjcajbgh	 h d j c a j b g h
efjc	 e f j c
cdd	 c d d
aaec	 a a e c
cijghfcb	 c i j g h f c b
gacagbg	 g a c a g b g
hjgjea	 h j g j e a
adaej	 a d a e j
eb	 e b
ffhfhi	 f f h f h i
fjjbg	 f j j b g
eaidaje	 e a i d a j e
dhhhh	 d h h h h
fdi	 f d i
jgfbdh	 j g f b d h
eghecfgif	 e g h e c f g i f
gghiade	 g g h i a d e
bc	 b c
fdgedba	 f d g e d b a
fdcgdi	 f d c g d i
ge	 g e
gbbjiffe	 g b b j i f f e
hehf	 h e h f
bhdbjc	 b h d b j c
ac	 a c
jiijbd	 j i i j b d
aeh	 a e h
fcic	 f c i c
ggffcagb	 g g f f c a g b
jjcje	 j j c j e
haaaida	 h a a a i d a
bjbcg	 b j b c g
aea	 a e a
dacjhcaj	 d a c j h c a j
gadgfhgbb	 g a d g f h g b b
da	 d a
accge	 a c c g e
dcibbjheb	 d c i b b j h e b
jbcijjc	 j b c i j j c
bi	 b i
bdiebccbf	 b d i e b c c b f
gb	 g b
icfaahh	 i c f a a h h
he	 h e
bbcjcf	 b b c j c f
ed	 e d
aegjfi	 a e g j f i
hghiaihd	 h g h i a i h d
da	 d a
dbffjhhj	 d b f f j h h j
dbcdhgge	 d b c d h g g e
dja	 d j a
fhec	 f h e c
fca	 f c a
cabjhbef	 c a b j h b e f
ciafib	 c i a f i b
eeicebcfb	 e e i c e b c f b
jggaefd	 j g g a e f d
ghjcigf	 g h j c i g f
fdhacf	 f d h a c f
fde	 f d e
hf	 h f
hah	 h a h
hbfi	 h b f i
gc	 g c
dbgj	 d b g j
gigicgfcb	 g i g i c g f c b
afdjaa	 a f d j a a
fcgceaeh	 f c g c e a e h
ghed	 g h e d
ddgieehgj	 d d g i e e h g j
aefechh	 a e f e c h h
gjjhjfgi	 g j j h j f g i
bdced	 b d c e d
ffae	 f f a e
gahjhbeih	 g a h j h b e i h
aebejhafj	 a e b e j h a f j
hebcdja	 h e b c d j a
cdeagaf	 c d e a g a f
dd	 d d
fddijc	 f d d i j c
efgjdeicd	 e f g j d e i c d
gejd	 g e j d
hcaaccb	 h c a a c c b
jdhbiie	 j d h b i i e
ebafi	 e b a f i
hc	 h c
beigge	 b e i g g e
jfhf	 j f h f
ighhbgh	 i g h h b g h
gjehdid	 g j e h d i d
jgejibaaj	 j g e j i b a a j
aaggbega	 a a g g b e g a
bdhchibi	 b d h c h i b i
idcgcej	 i d c g c e j
jgjbjabc	 j g j b j a b c
hj	 h j
egcefh	 e g c e f h
hef	 h e f
hcif	 h c i f
bcaiifadj	 b c a i i f a d j
chjfj	 c h j f j
aahea	 a a h e a
djhfebd	 d j h f e b d
ifidjh	 i f i d j h
be	 b e
jedhcg	 j e d h c g
agchg	 a g c h g
gbjbiedd	 g b j b i e d d
fcaehc	 f c a e h c
jjigbibic	 j j i g b i b i c
gidj	 g i d j
hjg	 h j g
gbfeab	 g b f e a b
egj	 e g j
aghbe	 a g h b e
gfcccjeh	 g f c c c j e h
fabjdejj	 f a b j d e j j
jddj	 j d d j
ehbab	 e h b a b
bdifgihi	 b d i f g i h i
ejadg	 e j a d g
bh	 b h
ecbhd	 e c b h d
dch	 d c h
bae	 b a e
fbgej	 f b g e j
afd	 a f d
fhfaf	 f h f a f
hdac	 h d a c
jaiaa	 j a i a a
ej	 e j
hbfb	 h b f b
ciadjfhdg	 c i a d j f h d g
idgde	 i d g d e
afhcf	 a f h c f
fj	 f j
dhheggcg	 d h h e g g c g
fifibf	 f i f i b f
acaejdb	 a c a e j d b
gjihfd	 g j i h f d
jjbfajac	 j j b f a j a c
jj	 j j
abiaffdbb	 a b i a f f d b b
cgb	 c g b
jjeebdchf	 j j e e b d c h f
babgjh	 b a b g j h
ggga	 g g g a
ada	 a d a
jfhififfb	 j f h i f i f f b
ceffjg	 c e f f j g
bgfccehb	 b g f c c e h b
gbabidfh	 g b a b i d f h
aefhic	 a e f h i c
bi	 b i
icedhje	 i c e d h j e
gbagajdh	 g b a g a j d h
bcc	 b c c
bdahfbfca	 b d a h f b f c a
ehbaj	 e h b a j
gc	 g c
hhdjjhejh	 h h d j j h e j h
dg	 d g
gceia	 g c e i a
fcddei	 f c d d e i
ghjeefbb	 g h j e e f b b
ed	 e d
jda	 j d a
aihajhc	 a i h a j h c
eajcdig	 e a j c d i g
feicadgaj	 f e i c a d g a j
igh	 i g h
jgbeie	 j g b e i e
dj	 d j
aiichj	 a i i c h j
jae	 j a e
jaa	 j a a
chicegbai	 c h i c e g b a i
ibia	 i b i a
hdjibbegc	 h d j i b b e g c
adeaje	 a d e a j e
ibjbia	 i b j b i a
efafhfbeb	 e f a f h f b e b
da	 d a
jbjij	 j b j i j
caabe	 c a a b e
fijdcda	 f i j d c d a
eacdibh	 e a c d i b h
bij	 b i j
idebcfhj	 i d e b c f h j
fahbhd	 f a h b h d
abjhj	 a b j h j
gfidfccbd	 g f i d f c c b d
ehg	 e h g
gccf	 g c c f
ibjaj	 i b j a j
fggegcaef	 f g g e g c a e f
cdfdi	 c d f d i
iiji	 i i j i
chah	 c h a h
ibh	 i b h
gha	 g h a
djc	 d j c
jja	 j j a
ejbdahad	 e j b d a h a d
bgfgajf	 b g f g a j f
db	 d b
gebe	 g e b e
ggic	 g g i c
edjhceddh	 e d j h c e d d h
bgia	 b g i a
bbidijge	 b b i d i j g e
cch	 c c h
fghj	 f g h j
eae	 e a e
fhacagb	 f h a c a g b
hgg	 h g g
eggja	 e g g j a
ceiijbeh	 c e i i j b e h
hbggfbb	 h b g g f b b
gcacjef	 g c a c j e f
igacf	 i g a c f
eeaef	 e e a e f
jbffhb	 j b f f h b
deabehcbd	 d e a b e h c b d
bighf	 b i g h f
jaddgbfcb	 j a d d g b f c b
geaj	 g e a j
agibj	 a g i b j
iahgcc	 i a h g c c
ig	 i g
adbcb	 a d b c b
gjhjaefd	 g j h j a e f d
hfhdhb	 h f h d h b
aigec	 a i g e c
idcafedeh	 i d c a f e d e h
chcigeji	 c h c i g e j i
eihba	 e i h b a
ab	 a b
jfiahbed	 j f i a h b e d
agggdja	 a g g g d j a
ihg	 i h g
hab	 h a b
ghdagcjcc	 g h d a g c j c c
fefhej	 f e f h e j
aihie	 a i h i e
daeehbjbi	 d a e e h b j b i
badgh	 b a d g h
hgiebhag	 h g i e b h a g
ibggch	 i b g g c h
aeb	 a e b
ecifbjbji	 e c i f b j b j i
dcci	 d c c i
cbfabeed	 c b f a b e e d
cfbfhcej	 c f b f h c e j
afh	 a f h
idaiahf	 i d a i a h f
jbcbhjai	 j b c b h j a i
bieeg	 b i e e g
dcabi	 d c a b i
bj	 b j
eagjfhia	 e a g j f h i a
dcceggfic	 d c c e g g f i c
eg	 e g
jgbgdcbcf	 j g b g d c b c f
hjgb	 h j g b
jdfegd	 j d f e g d
hhjjfic	 h h j j f i c
ijjggi	 i j j g g i
hhagc	 h h a g c
aaebaj	 a a e b a j
egiccd	 e g i c c d
hifhbe	 h i f h b e
echhbca	 e c h h b c a
jbjidihdj	 j b j i d i h d j
cce	 c c e
af	 a f
giea	 g i e a
jfa	 j f a
cejgahj	 c e j g a h j
cfgbcggc	 c f g b c g g c
fb	 f b
ebjfbebf	 e b j f b e b f
hdcbci	 h d c b c i
de	 d e
ebafcfdeh	 e b a f c f d e h
jdfgfa	 j d f g f a
deejj	 d e e j j
gge	 g g e
acdiiejg	 a c d i i e j g
cd	 c d
ceb	 c e b
iej	 i e j
fgchahi	 f g c h a h i
cije	 c i j e
ffdadahc	 f f d a d a h c
fjcbbh	 f j c b b h
jfedegjib	 j f e d e g j i b
cafihjj	 c a f i h j j
cf	 c f
fhbfig	 f h b f i g
fbdjeeb	 f b d j e e b
adjihgh	 a d j i h g h
cjecaj	 c j e c a j
jfga	 j f g a
fa	 f a
hjeagcg	 h j e a g c g
bebc	 b e b c
gf	 g f
feih	 f e i h
ihff	 i h f f
ciifif	 c i i f i f
beaih	 b e a i h
fhhd	 f h h d
fgfje	 f g f j e
ghghggfie	 g h g h g g f i e
eaiiig	 e a i i i g
chigcdi	 c h i g c d i
idhbbjdd	 i d h b b j d d
iddgidgib	 i d d g i d g i b
hg	 h g
dhiaheabd	 d h i a h e a b d
fdchgifh	 f d c h g i f h
hehd	 h e h d
bgf	 b g f
hegfeb	 h e g f e b
ee	 e e
ijia	 i j i a
bgacej	 b g a c e j
fbfgagegb	 f b f g a g e g b
dihedbedi	 d i h e d b e d i
gg	 g g
bfe	 b f e
gdbab	 g d b a b
gejbai	 g e j b a i
cgafficjb	 c g a f f i c j b
ebdajbf	 e b d a j b f
bbcghd	 b b c g h d
bijae	 b i j a e
gdhi	 g d h i
efdjhjiid	 e f d j h j i i d
dhgfde	 d h g f d e
iicceecdb	 i i c c e e c d b
jgd	 j g d
bdjidfhe	 b d j i d f h e
ajjgbda	 a j j g b d a
fdgcgd	 f d g c g d
gjffa	 g j f f a
hiehgbchd	 h i e h g b c h d
ffif	 f f i f
baga	 b a g a
addjjah	 a d d j j a h
aii	 a i i
jea	 j e a
difaag	 d i f a a g
jjebjf	 j j e b j f
iaajdjfjc	 i a a j d j f j c
iifbibei	 i i f b i b e i
daibegac	 d a i b e g a c
cigdafj	 c i g d a f j
didfbc	 d i d f b c
adgbigc	 a d g b i g c
hfeaegj	 h f e a e g j
cic	 c i c
hegej	 h e g e j
fhf	 f h f
hdecifc	 h d e c i f c
hicjjahag	 h i c j j a h a g
eheeegbhf	 e h e e e g b h f
fagdg	 f a g d g
ffigbba	 f f i g b b a
bcieih	 b c i e i h
af	 a f
fjdaijg	 f j d a i j g
fcifjdf	 f c i f j d f
ggbegdbfa	 g g b e g d b f a
ecehegdah	 e c e h e g d a h
iaiejjab	 i a i e j j a b
jdhecgad	 j d h e c g a d
jgbjh	 j g b j h
aihdc	 a i h d c
ghccbc	 g h c c b c
bddfiea	 b d d f i e a
cbj	 c b j
ciefjhe	 c i e f j h e
iij	 i i j
hid	 h i d
cbjchi	 c b j c h i
bjhhehf	 b j h h e h f
fid	 f i d
fibcah	 f i b c a h
aeieijaib	 a e i e i j a i b
aghehg	 a g h e h g
ggjbgiaah	 g g j b g i a a h
ebebdb	 e b e b d b
fdc	 f d c
cdffjbe	 c d f f j b e
ggchaigif	 g g c h a i g i f
hhhhe	 h h h h e
cc	 c c
gidjfhgii	 g i d j f h g i i
feb	 f e b
achaigg	 a c h a i g g
gee	 g e e
fh	 f h
gidcjee	 g i d c j e e
hdiahagbj	 h d i a h a g b j
gj	 g j
dffj	 d f f j
gcchhagfc	 g c c h h a g f c
fdjhcc	 f d j h c c
fehagbgah	 f e h a g b g a h
ad	 a d
ha	 h a
af	 a f
hj	 h j
bhaai	 b h a a i
ehdfdejeg	 e h d f d e j e g
cbi	 c b i
bbfib	 b b f i b
eaacffgji	 e a a c f f g j i
ice	 i c e
dggfghdba	 d g g f g h d b a
ajgeeha	 a j g e e h a
gehca	 g e h c a
hhff	 h h f f
hgbefa	 h g b e f a
jd	 j d
ha	 h a
ejchheec	 e j c h h e e c
cfgb	 c f g b
ihcgcefhf	 i h c g c e f h f
dgacai	 d g a c a i
ehfidcee	 e h f i d c e e
bhaheh	 b h a h e h
bcih	 b c i h
hcjefbe	 h c j e f b e
chbba	 c h b b a
hjaaj	 h j a a j
jgfga	 j g f g a
gdefg	 g d e f g
bbeb	 b b e b
jceagchhg	 j c e a g c h h g
jdbe	 j d b e
aaed	 a a e d
hagfejdg	 h a g f e j d g
bjej	 b j e j
ifi	 i f i
ccdacdeh	 c c d a c d e h
fcjh	 f c j h
eccjffg	 e c c j f f g
ibh	 i b h
ihghefda	 i h g h e f d a
giagjbfbd	 g i a g j b f b d
eihgdhjj	 e i h g d h j j
gfhcbacja	 g f h c b a c j a
icbhii	 i c b h i i
hjbffdd	 h j b f f d d
fgeaj	 f g e a j
jjjfhhf	 j j j f h h f
gb	 g b
fcggeegj	 f c g g e e g j
gfggi	 g f g g i
aj	 a j
jcabad	 j c a b a d
chefdf	 c h e f d f
bebfiaei	 b e b f i a e i
gbheg	 g b h e g
agfcjfcae	 a g f c j f c a e
iacgbhjhd	 i a c g b h j h d
efd	 e f d
aehjff	 a e h j f f
ejeahchda	 e j e a h c h d a
addcia	 a d d c i a
bb	 b b
ea	 e a
jabdfddjg	 j a b d f d d j g
abhhiege	 a b h h i e g e
ajf	 a j f
efifaijaf	 e f i f a i j a f
gd	 g d
jdgcjcjfe	 j d g c j c j f e
eajia	 e a j i a
dhchjagig	 d h c h j a g i g
icieddje	 i c i e d d j e
dabjgh	 d a b j g h
jehcghahg	 j e h c g h a h g
cja	 c j a
jccbgcgj	 j c c b g c g j
cjdecfii	 c j d e c f i i
jbaaa	 j b a a a
aff	 a f f
cc	 c c
fhfaecf	 f h f a e c f
ibej	 i b e j
fbfdh	 f b f d h
fhfgg	 f h f g g
ihgh	 i h g h
hg	 h g
fjcb	 f j c b
abd	 a b d
hf	 h f
fhh	 f h h
ih	 i h
gdec	 g d e c
djag	 d j a g
gbgah	 g b g a h
aiebfi	 a i e b f i
hfjiefica	 h f j i e f i c a
ggdd	 g g d d
hddicf	 h d d i c f
ebcbij	 e b c b i j
jhfcbcee	 j h f c b c e e
ij	 i j
fcfeijgfa	 f c f e i j g f a
cccgiehfb	 c c c g i e h f b
iheii	 i h e i i
gegfcaaif	 g e g f c a a i f
dfc	 d f c
dabgdaf	 d a b g d a f
gbfahh	 g b f a h h
dbcjidj	 d b c j i d j
ifbeejei	 i f b e e j e i
iifheieje	 i i f h e i e j e
jbeeec	 j b e e e c
hihcfc	 h i h c f c
ghed	 g h e d
egedgchhc	 e g e d g c h h c
aci	 a c i
fbbfe	 f b b f e
dicffbhj	 d i c f f b h j
igah	 i g a h
bi	 b i
ddhea	 d d h e a
ajfcie	 a j f c i e
fcb	 f c b
gcjcafj	 g c j c a f j
fiche	 f i c h e
edg	 e d g
eibd	 e i b d
ci	 c i
daghahhh	 d a g h a h h h
igjfieb	 i g j f i e b
ejbi	 e j b i
iiji	 i i j i
baicidj	 b a i c i d j
gfbjd	 g f b j d
iiae	 i i a e
adjc	 a d j c
faf	 f a f
aeich	 a e i c h
ihiiej	 i h i i e j
gjdiebi	 g j d i e b i
eaidgef	 e a i d g e f
bafi	 b a f i
ddfffg	 d d f f f g
fcahhdfc	 f c a h h d f c
hcjg	 h c j g
icibg	 i c i b g
ahbjheff	 a h b j h e f f
haadda	 h a a d d a
fe	 f e
baij	 b a i j
ddegebhd	 d d e g e b h d
jddcbbeee	 j d d c b b e e e
gagc	 g a g c
cb	 c b
ff	 f f
bfh	 b f h
jibbchc	 j i b b c h c
jbibgbae	 j b i b g b a e
chbdi	 c h b d i
gbh	 g b h
fhgjg	 f h g j g
eg	 e g
iibjjbjah	 i i b j j b j a h
ehd	 e h d
dcffjcc	 d c f f j c c
egfi	 e g f i
ci	 c i
hggef	 h g g e f
babd	 b a b d
ejidcf	 e j i d c f
jadfdd	 j a d f d d
bgd	 b g d
eehcdac	 e e h c d a c
af	 a f
ijgfa	 i j g f a
difjgc	 d i f j g c
chhgaj	 c h h g a j
djaifhhaa	 d j a i f h h a a
ahdh	 a h d h
cc	 c c
ie	 i e
bjeh	 b j e h
eh	 e h
iagfh	 i a g f h
fdh	 f d h
hdifg	 h d i f g
dhjehccji	 d h j e h c c j i
djhbdc	 d j h b d c
bffj	 b f f j
jddhdbec	 j d d h d b e c
aabbgj	 a a b b g j
hjbgfbg	 h j b g f b g
gad	 g a d
efe	 e f e
ccdadf	 c c d a d f
igjhee	 i g j h e e
iajbcbcb	 i a j b c b c b
cag	 c a g
ccb	 c c b
beb	 b e b
hgbbffi	 h g b b f f i
ci	 c i
aj	 a j
ijj	 i j j
deadj	 d e a d j
edhc	 e d h c
fccjcfdia	 f c c j c f d i a
ijeb	 i j e b
hci	 h c i
iacjhcaa	 i a c j h c a a
jehad	 j e h a d
efbacigca	 e f b a c i g c a
cgggge	 c g g g g e
iicfebjdg	 i i c f e b j d g
hgcfa	 h g c f a
dgefida	 d g e f i d a
djbeb	 d j b e b
fahb	 f a h b
iafb	 i a f b
cggcbd	 c g g c b d
bcheijiga	 b c h e i j i g a
ejfiiagfc	 e j f i i a g f c
cjbbbi	 c j b b b i
efa	 e f a
ibhbddcc	 i b h b d d c c
iigeedhej	 i i g e e d h e j
fjih	 f j i h
gdaggjfb	 g d a g g j f b
ffdabjh	 f f d a b j h
jcadfjgic	 j c a d f j g i c
gefdcgi	 g e f d c g i
eajfec	 e a j f e c
fdjgfee	 f d j g f e e
eahcceehb	 e a h c c e e h b
iigabf	 i i g a b f
ibggccb	 i b g g c c b
aiebfji	 a i e b f j i
hfiacb	 h f i a c b
ijcfa	 i j c f a
abd	 a b d
bjjheg	 b j j h e g
jhc	 j h c
fegiddggh	 f e g i d d g g h
ggce	 g g c e
bjbecaf	 b j b e c a f
dc	 d c
jbfe	 j b f e
jfag	 j f a g
dcchegab	 d c c h e g a b
adcfdcjjc	 a d c f d c j j c
ahjdgdgff	 a h j d g d g f f
fggigajee	 f g g i g a j e e
cefbbf	 c e f b b f
fbejeecda	 f b e j e e c d a
dji	 d j i
cc	 c c
eec	 e e c
adb	 a d b
hh	 h h
fjbffhefh	 f j b f f h e f h
bidchch	 b i d c h c h
fbhfd	 f b h f d
cgifb	 c g i f b
dgaidgdb	 d g a i d g d b
ejh	 e j h
jfiaa	 j f i a a
afaffgh	 a f a f f g h
gfcfhe	 g f c f h e
efgihj	 e f g i h j
gaibaeffb	 g a i b a e f f b
dj	 d j
hee	 h e e
bdd	 b d d
ggj	 g g j
fgcb	 f g c b
ce	 c e
jd	 j d
fie	 f i e
gdjaei	 g d j a e i
ejcbgfac	 e j c b g f a c
biidbcjf	 b i i d b c j f
cdje	 c d j e
ecejgjh	 e c e j g j h
icfeiaheh	 i c f e i a h e h
fegefgd	 f e g e f g d
cfb	 c f b
jfbbbh	 j f b b b h
figfaf	 f i g f a f
fhhccf	 f h h c c f
igaefij	 i g a e f i j
hafgbd	 h a f g b d
jge	 j g e
bddbaa	 b d d b a a
iifg	 i i f g
bidici	 b i d i c i
ghfdba	 g h f d b a
ghgebf	 g h g e b f
fidi	 f i d i
jeha	 j e h a
hebaac	 h e b a a c
ife	 i f e
ddbbbf	 d d b b b f
dajfb	 d a j f b
ihj	 i h j
hd	 h d
ad	 a d
jdbjj	 j d b j j
jcgcf	 j c g c f
edc	 e d c
cgbhibbc	 c g b h i b b c
gfacghj	 g f a c g h j
decgci	 d e c g c i
heeaig	 h e e a i g
hagd	 h a g d
bh	 b h
aedad	 a e d a d
ffafhg	 f f a f h g
jhfac	 j h f a c
fhdcejddb	 f h d c e j d d b
dehedgj	 d e h e d g j
aaddiei	 a a d d i e i
iddech	 i d d e c h
hhhd	 h h h d
aaa	 a a a
heh	 h e h
fdgb	 f d g b
dbc	 d b c
dgjh	 d g j h
fijb	 f i j b
hjhdijfb	 h j h d i j f b
djf	 d j f
djhbcfheb	 d j h b c f h e b
ib	 i b
hiafdfd	 h i a f d f d
hc	 h c
hjidejh	 h j i d e j h
cf	 c f
ghjfebia	 g h j f e b i a
ide	 i d e
aifa	 a i f a
bdchhbc	 b d c h h b c
afhddaah	 a f h d d a a h
jfjai	 j f j a i
cchdeb	 c c h d e b
eg	 e g
jhi	 j h i
djabca	 d j a b c a
gegcbich	 g e g c b i c h
jiecgh	 j i e c g h
idcd	 i d c d
haec	 h a e c
da	 d a
jbaai	 j b a a i
hhfh	 h h f h
gjaaheja	 g j a a h e j a
cjadiedbh	 c j a d i e d b h
hhg	 h h g
jefbdab	 j e f b d a b
biddcd	 b i d d c d
cha	 c h a
cfj	 c f j
iehjej	 i e h j e j
agca	 a g c a
cc	 c c
gga	 g g a
fcdhbfga	 f c d h b f g a
aa	 a a
hdgjdbajc	 h d g j d b a j c
hbejffj	 h b e j f f j
bbbfccg	 b b b f c c g
bhb	 b h b
gai	 g a i
hfhc	 h f h c
gghb	 g g h b
ebaice	 e b a i c e
hjffe	 h j f f e
bg	 b g
hcj	 h c j
gifgcc	 g i f g c c
cbajagj	 c b a j a g j
ei	 e i
ehab	 e h a b
hbfebahee	 h b f e b a h e e
af	 a f
fihefdhg	 f i h e f d h g
fgeddefc	 f g e d d e f c
ecbj	 e c b j
bgb	 b g b
bb	 b b
adgeehbf	 a d g e e h b f
be	 b e
jjagd	 j j a g d
fidbjhcba	 f i d b j h c b a
eifcebj	 e i f c e b j
bidgbcf	 b i d g b c f
ddhicdced	 d d h i c d c e d
djd	 d j d
bgehj	 b g e h j
cjj	 c j j
hhgbfa	 h h g b f a
ciaabg	 c i a a b g
gbjfgchhj	 g b j f g c h h j
jhbhjeg	 j h b h j e g
afeegffb	 a f e e g f f b
hgfei	 h g f e i
bfbbdjdgj	 b f b b d j d g j
hffeg	 h f f e g
fe	 f e
bbhed	 b b h e d
ahjiiahbj	 a h j i i a h b j
jj	 j j
fdfdfic	 f d f d f i c
ga	 g a
hhiidahac	 h h i i d a h a c
jdgb	 j d g b
hbbdgfefg	 h b b d g f e f g
hcaae	 h c a a e
ff	 f f
hf	 h f
cbf	 c b f
eeegbfff	 e e e g b f f f
bfhjigca	 b f h j i g c a
abdgi	 a b d g i
jhaiaac	 j h a i a a c
dg	 d g
adf	 a d f
hggdbe	 h g g d b e
gcbiejaea	 g c b i e j a e a
baeafiaa	 b a e a f i a a
agf	 a g f
chbfg	 c h b f g
aefhb	 a e f h b
cjeaifd	 c j e a i f d
ggagfhjg	 g g a g f h j g
gcggjgdh	 g c g g j g d h
hedda	 h e d d a
bh	 b h
idef	 i d e f
gdehei	 g d e h e i
cdf	 c d f
jjjei	 j j j e i
ecc	 e c c
ij	 i j
hheachcb	 h h e a c h c b
igghhihcg	 i g g h h i h c g
dhfbhejgc	 d h f b h e j g c
bhgeab	 b h g e a b
gdgiajhc	 g d g i a j h c
gefedigaf	 g e f e d i g a f
cbjc	 c b j c
adbfefbd	 a d b f e f b d
aajcje	 a a j c j e
ga	 g a
bbibdhf	 b b i b d h f
efjaae	 e f j a a e
gacabgaf	 g a c a b g a f
debdh	 d e b d h
ijbfiff	 i j b f i f f
igij	 i g i j
aijgjhefd	 a i j g j h e f d
dgha	 d g h a
hdbiejd	 h d b i e j d
jddgcjic	 j d d g c j i c
hhahcfeag	 h h a h c f e a g
eicehbh	 e i c e h b h
hh	 h h
ejhjadcb	 e j h j a d c b
cdheej	 c d h e e j
dehhehci	 d e h h e h c i
fcbfbc	 f c b f b c
gf	 g f
jjjchg	 j j j c h g
aadad	 a a d a d
dihegjff	 d i h e g j f f
gedaj	 g e d a j
cgeggc	 c g e g g c
eaid	 e a i d
adbjfbf	 a d b j f b f
gd	 g d
bfhf	 b f h f
aib	 a i b
gfdi	 g f d i
hige	 h i g e
bfahhff	 b f a h h f f
gg	 g g
iecdjib	 i e c d j i b
efhgj	 e f h g j
eabajcge	 e a b a j c g e
fh	 f h
jggecdifb	 j g g e c d i f b
ggjb	 g g j b
fgdfgh	 f g d f g h
gbajbh	 g b a j b h
dfje	 d f j e
jejhga	 j e j h g a
ghbbbc	 g h b b b c
fiai	 f i a i
cec	 c e c
hfaabfjh	 h f a a b f j h
hgfiaf	 h g f i a f
eggeee	 e g g e e e
cffh	 c f f h
ejffbiid	 e j f f b i i d
ceichdfh	 c e i c h d f h
ggbicgdef	 g g b i c g d e f
aifg	 a i f g
haiafdbdj	 h a i a f d b d j
bei	 b e i
ighcdefag	 i g h c d e f a g
ajcedegig	 a j c e d e g i g
jbg	 j b g
dbjiaadi	 d b j i a a d i
bcfaiee	 b c f a i e e
jbaic	 j b a i c
daaegg	 d a a e g g
cdh	 c d h
ijej	 i j e j
hdabgf	 h d a b g f
hejgdj	 h e j g d j
bdf	 b d f
geci	 g e c i
ecicccage	 e c i c c c a g e
hhjbdfdgg	 h h j b d f d g g
ja	 j a
ebefgfja	 e b e f g f j a
dfagg	 d f a g g
jfci	 j f c i
eba	 e b a
fgba	 f g b a
egjbbbjhe	 e g j b b b j h e
gbdddh	 g b d d d h
di	 d i
dbfh	 d b f h
debc	 d e b c
baicdieg	 b a i c d i e g
bdc	 b d c
ead	 e a d
dfci	 d f c i
gje	 g j e
cddbbhied	 c d d b b h i e d
dbhj	 d b h j
addd	 a d d d
dhahhidd	 d h a h h i d d
ejcdajj	 e j c d a j j
fbcjcideh	 f b c j c i d e h
jddfiebgi	 j d d f i e b g i
gh	 g h
cibebdbc	 c i b e b d b c
cbbjfdid	 c b b j f d i d
hjhdefi	 h j h d e f i
bejec	 b e j e c
babafhac	 b a b a f h a c
ehchjb	 e h c h j b
adh	 a d h
ijbiacjcg	 i j b i a c j c g
fggdf	 f g g d f
ehhhac	 e h h h a c
eg	 e g
hggfhgaa	 h g g f h g a a
efcji	 e f c j i
jgjhfjch	 j g j h f j c h
hebice	 h e b i c e
hafajfgg	 h a f a j f g g
bgdi	 b g d i
cdhjfdee	 c d h j f d e e
cg	 c g
ihcb	 i h c b
gfg	 g f g
gfghab	 g f g h a b
efihijeei	 e f i h i j e e i
cdceea	 c d c e e a
gdb	 g d b
aiagb	 a i a g b
dggcdcbhj	 d g g c d c b h j
ddei	 d d e i
hdjeg	 h d j e g
jaagi	 j a a g i
dgfhhh	 d g f h h h
ebfhhd	 e b f h h d
hhefhc	 h h e f h c
iic	 i i c
gj	 g j
jbiafhc	 j b i a f h c
aba	 a b a
bcf	 b c f
cddehjgh	 c d d e h j g h
cihca	 c i h c a
ffg	 f f g
digfci	 d i g f c i
hj	 h j
jgde	 j g d e
gieie	 g i e i e
hbaih	 h b a i h
ad	 a d
icbh	 i c b h
hgaeiagbh	 h g a e i a g b h
fgfifaci	 f g f i f a c i
ege	 e g e
dfaaffdd	 d f a a f f d d
gehfb	 g e h f b
jdjd	 j d j d
ibegb	 i b e g b
hi	 h i
gbdgab	 g b d g a b
jfadhjhia	 j f a d h j h i a
biehch	 b i e h c h
dehhcgi	 d e h h c g i
igbhjghig	 i g b h j g h i g
ejhcidgb	 e j h c i d g b
agfhfd	 a g f h f d
edafjgg	 e d a f j g g
eegh	 e e g h
jeiba	 j e i b a
fbhcf	 f b h c f
cjg	 c j g
jifcdj	 j i f c d j
gjaea	 g j a e a
bb	 b b
ddc	 d d c
hgijac	 h g i j a c
jff	 j f f
jejid	 j e j i d
ijfifajf	 i j f i f a j f
hegcj	 h e g c j
cghbbdch	 c g h b b d c h
hjehefj	 h j e h e f j
edghbdj	 e d g h b d j
gj	 g j
ecdfgj	 e c d f g j
hcgbdebge	 h c g b d e b g e
bgfjjbch	 b g f j j b c h
fifgadj	 f i f g a d j
jehagh	 j e h a g h
eehfcb	 e e h f c b
afh	 a f h
gd	 g d
hdabgff	 h d a b g f f
iacfeaaad	 i a c f e a a a d
aj	 a j
bbbjf	 b b b j f
gccigh	 g c c i g h
jecibih	 j e c i b i h
bagcfcja	 b a g c f c j a
hdbbi	 h d b b i
dh	 d h
bdid	 b d i d
aiifegjfi	 a i i f e g j f i
cdddaibj	 c d d d a i b j
gjhgcagja	 g j h g c a g j a
ac	 a c
fadc	 f a d c
ddfha	 d d f h a
hbdcdh	 h b d c d h
gibaa	 g i b a a
eaghjfhih	 e a g h j f h i h
jjidehi	 j j i d e h i
gg	 g g
jggj	 j g g j
chbcg	 c h b c g
ifdhhhgb	 i f d h h h g b
biiee	 b i i e e
idj	 i d j
ihjigbef	 i h j i g b e f
ghjfag	 g h j f a g
bbaf	 b b a f
jag	 j a g
dfcbbcgec	 d f c b b c g e c
hagabh	 h a g a b h
gcicf	 g c i c f
ejdacafg	 e j d a c a f g
efeegd	 e f e e g d
gbaa	 g b a a
bchgddb	 b c h g d d b
fbef	 f b e f
fecccg	 f e c c c g
chjdiaa	 c h j d i a a
agb	 a g b
giee	 g i e e
cadfg	 c a d f g
daje	 d a j e
jbigei	 j b i g e i
bajadcdde	 b a j a d c d d e
ifjcdf	 i f j c d f
jifbajdd	 j i f b a j d d
hj	 h j
haa	 h a a
je	 j e
ggbja	 g g b j a
fjajghh	 f j a j g h h
aafefjfdg	 a a f e f j f d g
ffabggddi	 f f a b g g d d i
bg	 b g
ciag	 c i a g
bjjhdjb	 b j j h d j b
fadica	 f a d i c a
deegbfid	 d e e g b f i d
fe	 f e
ddgjcjhbc	 d d g j c j h b c
deffibahh	 d e f f i b a h h
eaaccdfcc	 e a a c c d f c c
hafi	 h a f i
hjbda	 h j b d a
bgeifcac	 b g e i f c a c
eibggd	 e i b g g d
ha	 h a
if	 i f
igghbbibj	 i g g h b b i b j
bfa	 b f a
dbihhjj	 d b i h h j j
fijhc	 f i j h c
ffjbc	 f f j b c
if	 i f
acjjebdbc	 a c j j e b d b c
bhhhb	 b h h h b
bdiae	 b d i a e
fbfbhjehd	 f b f b h j e h d
dcebi	 d c e b i
dfdbcbde	 d f d b c b d e
cia	 c i a
bgd	 b g d
gfcfjficf	 g f c f j f i c f
eb	 e b
efhdd	 e f h d d
bjhf	 b j h f
dfffacj	 d f f f a c j
fbd	 f b d
ihhi	 i h h i
bcjhciafj	 b c j h c i a f j
ccbhihfbf	 c c b h i h f b f
cbeif	 c b e i f
if	 i f
adgajbijb	 a d g a j b i j b
hb	 h b
jieb	 j i e b
cbidb	 c b i d b
cg	 c g
ahjeiagg	 a h j e i a g g
jajdc	 j a j d c
dddbidjgb	 d d d b i d j g b
cfeeci	 c f e e c i
bcacbbfaa	 b c a c b b f a a
hb	 h b
gebe	 g e b e
cjgdadfe	 c j g d a d f e
je	 j e
diddge	 d i d d g e
gb	 g b
cefjda	 c e f j d a
faaddc	 f a a d d c
iej	 i e j
hbf	 h b f
bdi	 b d i
ecegj	 e c e g j
hfdb	 h f d b
hbchgfga	 h b c h g f g a
acdgdhdi	 a c d g d h d i
dhiaihfhb	 d h i a i h f h b
bh	 b h
hfccb	 h f c c b
bbhgi	 b b h g i
fc	 f c
bhacf	 b h a c f
gbibgbaca	 g b i b g b a c a
ccgfehjed	 c c g f e h j e d
iddjibgfh	 i d d j i b g f h
adiaggfg	 a d i a g g f g
jfdcgegda	 j f d c g e g d a
ahbbehcfe	 a h b b e h c f e
fdcdbf	 f d c d b f
ajeeddcb	 a j e e d d c b
ceej	 c e e j
ge	 g e
gf	 g f
big	 b i g
fhabhi	 f h a b h i
dbaiaei	 d b a i a e i
fbefg	 f b e f g
beaifd	 b e a i f d
edih	 e d i h
dadadgiee	 d a d a d g i e e
ieei	 i e e i
dffa	 d f f a
ieg	 i e g
cfde	 c f d e
gfgcbbb	 g f g c b b b
dbjd	 d b j d
gidicegj	 g i d i c e g j
gfijj	 g f i j j
bceghij	 b c e g h i j
hacb	 h a c b
dc	 d c
efahff	 e f a h f f
eaief	 e a i e f
eje	 e j e
bdfcahhec	 b d f c a h h e c
hc	 h c
ajdafehcb	 a j d a f e h c b
ddiadf	 d d i a d f
bdjigac	 b d j i g a c
fb	 f b
jedfj	 j e d f j
cbbbeji	 c b b b e j i
fdaigaaa	 f d a i g a a a
hh	 h h
hidbhf	 h i d b h f
ggfe	 g g f e
deefjdij	 d e e f j d i j
de	 d e
fj	 f j
bc	 b c
dejhggg	 d e j h g g g
ddjah	 d d j a h
bciihbca	 b c i i h b c a
aibaabcai	 a i b a a b c a i
jaii	 j a i i
chjcddh	 c h j c d d h
bjaiebie	 b j a i e b i e
bje	 b j e
fcej	 f c e j
jaiai	 j a i a i
dgeffij	 d g e f f i j
dciiijafi	 d c i i i j a f i
difgadceb	 d i f g a d c e b
hcechh	 h c e c h h
ccfdg	 c c f d g
edcij	 e d c i j
bhgfaibe	 b h g f a i b e
hegaacjjc	 h e g a a c j j c
jhcgjge	 j h c g j g e
fffhgji	 f f f h g j i
gdggf	 g d g g f
dbdeijaj	 d b d e i j a j
icabfab	 i c a b f a b
ieejjeff	 i e e j j e f f
chghdic	 c h g h d i c
ibhgfifjf	 i b h g f i f j f
gajgdac	 g a j g d a c
gfig	 g f i g
jhjfihd	 j h j f i h d
ifcicaf	 i f c i c a f
acbhaacjj	 a c b h a a c j j
begcffi	 b e g c f f i
ai	 a i
hbgdjf	 h b g d j f
bieedgj	 b i e e d g j
eg	 e g
egfhhh	 e g f h h h
adgficdj	 a d g f i c d j
gbhgeiddg	 g b h g e i d d g
ii	 i i
ijhb	 i j h b
gccj	 g c c j
fdeabe	 f d e a b e
echgahb	 e c h g a h b
ha	 h a
jghfaiahf	 j g h f a i a h f
djhahccg	 d j h a h c c g
cgjcge	 c g j c g e
bdhb	 b d h b
ihebdec	 i h e b d e c
fd	 f d
jhgb	 j h g b
cbbhjggda	 c b b h j g g d a
ciabfgf	 c i a b f g f
igf	 i g f
dij	 d i j
cfei	 c f e i
gjdccfb	 g j d c c f b
dg	 d g
hhhbbfi	 h h h b b f i
de	 d e
cgga	 c g g a
dc	 d c
bjj	 b j j
edfac	 e d f a c
bdbgbj	 b d b g b j
bgfigbie	 b g f i g b i e
ihjcdjie	 i h j c d j i e
ddiigdid	 d d i i g d i d
bgfc	 b g f c
dgejaaea	 d g e j a a e a
efj	 e f j
cadeaa	 c a d e a a
fj	 f j
dbidcec	 d b i d c e c
ged	 g e d
begcheg	 b e g c h e g
ggffffi	 g g f f f f i
ghfcfi	 g h f c f i
bgg	 b g g
bggg	 b g g g
ahdfgbi	 a h d f g b i
jed	 j e d
cciiegc	 c c i i e g c
gbeffidjb	 g b e f f i d j b
bghec	 b g h e c
dafhihbed	 d a f h i h b e d
fce	 f c e
ibdfdhe	 i b d f d h e
ghahac	 g h a h a c
ejga	 e j g a
dahda	 d a h d a
ceeci	 c e e c i
ch	 c h
hgghhhahf	 h g g h h h a h f
bagddaeee	 b a g d d a e e e
bghgf	 b g h g f
gjdfda	 g j d f d a
feihj	 f e i h j
jhae	 j h a e
djibbfe	 d j i b b f e
jjghdg	 j j g h d g
fe	 f e
jc	 j c
fgaeaf	 f g a e a f
dca	 d c a
jb	 j b
eihgjb	 e i h g j b
jiid	 j i i d
dabb	 d a b b
digdjgh	 d i g d j g h
edigfaj	 e d i g f a j
hehhgh	 h e h h g h
ad	 a d
cdgjdijge	 c d g j d i j g e
cb	 c b
ebi	 e b i
djeh	 d j e h
if	 i f
bjjgfb	 b j j g f b
fhhdjg	 f h h d j g
hfbicecac	 h f b i c e c a c
efijiaid	 e f i j i a i d
bihbfgcf	 b i h b f g c f
eechdbj	 e e c h d b j
cbfe	 c b f e
iedbceghh	 i e d b c e g h h
fbjagah	 f b j a g a h
dbf	 d b f
hjbffj	 h j b f f j
fiahbcg	 f i a h b c g
fgaajg	 f g a a j g
aiff	 a i f f
heha	 h e h a
fihdgh	 f i h d g h
cfeb	 c f e b
ibiffdcf	 i b i f f d c f
ahadiiegb	 a h a d i i e g b
jbfaiia	 j b f a i i a
hefa	 h e f a
chebhb	 c h e b h b
ajejccf	 a j e j c c f
bjehiacja	 b j e h i a c j a
bab	 b a b
ag	 a g
hib	 h i b
caihgbbji	 c a i h g b b j i
hfafigch	 h f a f i g c h
hjdfjah	 h j d f j a h
cgb	 c g b
caaeb	 c a a e b
fjifibg	 f j i f i b g
ijbdc	 i j b d c
fhhcg	 f h h c g
hf	 h f
efbhae	 e f b h a e
fdaajdhdf	 f d a a j d h d f
agccji	 a g c c j i
bgdaf	 b g d a f
acfg	 a c f g
djcdgde	 d j c d g d e
ajhfaijc	 a j h f a i j c
aaaegibjh	 a a a e g i b j h
iagjic	 i a g j i c
cjgc	 c j g c
gdi	 g d i
jbifcdig	 j b i f c d i g
aaadciaj	 a a a d c i a j
ggdba	 g g d b a
ibdf	 i b d f
jgj	 j g j
hhg	 h h g
dbeajjbf	 d b e a j j b f
gjgdgdbb	 g j g d g d b b
efaajd	 e f a a j d
idfdihgfh	 i d f d i h g f h
jgafgfai	 j g a f g f a i
cbgc	 c b g c
bgb	 b g b
jeiefji	 j e i e f j i
fbhdj	 f b h d j
aa	 a a
fjdahf	 f j d a h f
chhh	 c h h h
jdegbeabf	 j d e g b e a b f
bfj	 b f j
ccdf	 c c d f
daaddfbb	 d a a d d f b b
edijbbhd	 e d i j b b h d
ga	 g a
ecihbd	 e c i h b d
iihjb	 i i h j b
hbggdfjgb	 h b g g d f j g b
bgcbbag	 b g c b b a g
cfd	 c f d
ebfghadh	 e b f g h a d h
djhbh	 d j h b h
hfbeebjh	 h f b e e b j h
ici	 i c i
cg	 c g
dfiejhca	 d f i e j h c a
iaiifdbie	 i a i i f d b i e
bfbj	 b f b j
dihggd	 d i h g g d
hjc	 h j c
ahfgbj	 a h f g b j
aegji	 a e g j i
bjccbhhb	 b j c c b h h b
fi	 f i
jja	 j j a
abacfhhdh	 a b a c f h h d h
hebaceb	 h e b a c e b
fc	 f c
caa	 c a a
gddddidc	 g d d d d i d c
cha	 c h a
edbid	 e d b i d
eifja	 e i f j a
dbdabeb	 d b d a b e b
efabjabe	 e f a b j a b e
idghicadc	 i d g h i c a d c
hjbie	 h j b i e
bghghff	 b g h g h f f
bjafefeh	 b j a f e f e h
eaa	 e a a
jbe	 j b e
ijgg	 i j g g
gcbhcaia	 g c b h c a i a
cdijagdb	 c d i j a g d b
fecjagbge	 f e c j a g b g e
beb	 b e b
afjcicf	 a f j c i c f
jihche	 j i h c h e
cifeah	 c i f e a h
addijjjeg	 a d d i j j j e g
eadg	 e a d g
aabi	 a a b i
dc	 d c
ajccj	 a j c c j
edbjdjfh	 e d b j d j f h
abjfcba	 a b j f c b a
eh	 e h
cegc	 c e g c
caha	 c a h a
idjcg	 i d j c g
hacgjdbj	 h a c g j d b j
fh	 f h
bhdge	 b h d g e
jfbehiif	 j f b e h i i f
ecddae	 e c d d a e
djajcehfi	 d j a j c e h f i
fdijb	 f d i j b
bidhei	 b i d h e i
cfbdihgg	 c f b d i h g g
chgcajb	 c h g c a j b
djjfcigda	 d j j f c i g d a
jajcd	 j a j c d
djccaiiei	 d j c c a i i e i
abccje	 a b c c j e
beea	 b e e a
cdhhjjdbg	 c d h h j j d b g
jaiea	 j a i e a
bbe	 b b e
dfdcbahcj	 d f d c b a h c j
agiej	 a g i e j
cabjaf	 c a b j a f
ciggjbihg	 c i g g j b i h g
iagjf	 i a g j f
gegjibgbi	 g e g j i b g b i
fbgheicg	 f b g h e i c g
jada	 j a d a
bia	 b i a
hc	 h c
fabc	 f a b c
bc	 b c
cacegdcgg	 c a c e g d c g g
heidgcfed	 h e i d g c f e d
fafhcef	 f a f h c e f
gjhbihgd	 g j h b i h g d
ichhhg	 i c h h h g
ejagbgi	 e j a g b g i
cfif	 c f i f
dgj	 d g j
fjffg	 f j f f g
figcib	 f i g c i b
ji	 j i
hgagehgbd	 h g a g e h g b d
agdbad	 a g d b a d
gca	 g c a
fe	 f e
id	 i d
gjhde	 g j h d e
gib	 g i b
bei	 b e i
id	 i d
fhbbabfij	 f h b b a b f i j
fecjb	 f e c j b
ifajdcij	 i f a j d c i j
ehci	 e h c i
gicc	 g i c c
dcjahhj	 d c j a h h j
ibdbhid	 i b d b h i d
caag	 c a a g
gcjbccij	 g c j b c c i j
dichcch	 d i c h c c h
egicbhji	 e g i c b h j i
iiifgi	 i i i f g i
igddi	 i g d d i
ajej	 a j e j
iggfej	 i g g f e j
dbcbaa	 d b c b a a
jdebfg	 j d e b f g
jfegb	 j f e g b
iigb	 i i g b
bj	 b j
cj	 c j
hfjcegad	 h f j c e g a d
fddbgf	 f d d b g f
cbbidi	 c b b i d i
ge	 g e
ebbghjd	 e b b g h j d
iifif	 i i f i f
ag	 a g
fie	 f i e
gaabfid	 g a a b f i d
jhahae	 j h a h a e
fhd	 f h d
gecja	 g e c j a
efcgaf	 e f c g a f
bjefg	 b j e f g
abjhfjcdd	 a b j h f j c d d
dja	 d j a
jgadh	 j g a d h
hgchf	 h g c h f
ae	 a e
echfhdjfe	 e c h f h d j f e
jgdefbhjd	 j g d e f b h j d
cedihddig	 c e d i h d d i g
aif	 a i f
dejhigbj	 d e j h i g b j
hacj	 h a c j
djfihii	 d j f i h i i
igdacfjhh	 i g d a c f j h h
ebh	 e b h
jb	 j b
gghgjcfc	 g g h g j c f c
hgi	 h g i
cgef	 c g e f
aebaedgde	 a e b a e d g d e
bchb	 b c h b
hcedj	 h c e d j
cab	 c a b
jfcjcbide	 j f c j c b i d e
iaiicf	 i a i i c f
cj	 c j
ecgaf	 e c g a f
ib	 i b
bhif	 b h i f
ehhegfb	 e h h e g f b
fdgd	 f d g d
gjbjiei	 g j b j i e i
hajafjdg	 h a j a f j d g
fab	 f a b
bbib	 b b i b
cjgbee	 c j g b e e
eeceffhj	 e e c e f f h j
ggaejbcie	 g g a e j b c i e
gb	 g b
bidigaj	 b i d i g a j
fbeaeb	 f b e a e b
geaieijf	 g e a i e i j f
gec	 g e c
hg	 h g
ffbchhi	 f f b c h h i
gigaec	 g i g a e c
jaijhcgje	 j a i j h c g j e
fffgdehif	 f f f g d e h i f
djebfjfag	 d j e b f j f a g
cai	 c a i
cgcdchi	 c g c d c h i
jfg	 j f g
fifccdi	 f i f c c d i
